-55 -55 -57 -57 -55 -55 -57 -55 -55 -57 
-55 -55 -55 -55 -55 -55 -57 -55 -57 -57 
-55 -55 -55 -55 -55 -57 -67 -55 -55 -55 
-55 -57 -55 -55 -55 -55 -55 -57 -57 -55 
-55 -57 -55 -53 -57 -55 -55 -87 -53 -53 
-53 -57 -55 -53 -53 -53 -53 -53 -55 -53 
-55 -55 -53 -53 -55 -55 -55 -55 -55 -57 
-55 -55 -57 -57 -55 -55 -57 -55 -57 -57 
-57 -59 -59 -59 -59 -59 -59 -59 -59 -59 
-61 -59 -61 -57 -59 -57 -59 -55 -55 -55 
-55 -57 -57 -53 -55 -55 -55 -55 -55 -57 
-55 -55 -57 -57 -57 -59 -57 -57 -57 -57 
-57 -55 -55 -57 -55 -55 -57 -55 -55 -55 
-55 -57 -57 -57 -57 -55 -57 -55 -57 -55 
-57 -57 -55 -57 -59 -57 -55 -55 -57 -57 
-55 -55 -57 -55 -57 -55 -57 -63 -55 -55 
-55 -55 -57 -53 -55 -53 -91 -57 -55 -55 
-55 -55 -57 -57 -57 -59 -57 -57 -55 -57 
-55 -57 -57 -57 -55 -55 -57 -57 -55 -57 
-57 -59 -57 -59 -61 -63 -59 -61 -57 -61 
-63 -69 -61 -61 -59 -63 -59 -59 -57 -61 
-91 -59 -57 -59 -57 -63 -59 -61 -57 -59 
-57 -61 -59 -61 -57 -57 -57 -61 -57 -61 
-59 -61 -57 -59 -59 -61 -57 -57 -59 -61 
-59 -63 -59 -63 -55 -57 -53 -55 -57 -55 
-59 -57 -61 -59 -53 -57 -55 -59 -61 -57 
-61 -57 -57 -59 -57 -59 -59 -59 -59 -57 
-57 -57 -59 -59 -59 -59 -61 -55 -57 -59 
-57 -59 -57 -55 -57 -55 -55 -55 -55 -55 
-57 -55 -55 -53 -55 -55 -55 -57 -55 -55 
-57 -57 -55 -55 -55 -55 -55 -55 -55 -55 
-53 -55 -57 -57 -55 -57 -55 -55 -55 -55 
-57 -57 -57 -57 -91 -55 -57 -57 -57 -57 
-57 -57 -57 -59 -57 -55 -57 -57 -57 -57 
-55 -57 -55 -55 -55 -55 -57 -55 -55 -55 
-73 -55 -57 -55 -57 -55 -57 -55 -53 -55 
-55 -55 -55 -55 -55 -55 -55 -53 -53 -53 
-55 -55 -53 -55 -55 -55 -53 -53 -55 -55 
-53 -55 -53 -55 -55 -55 -53 -53 -55 -55 
-91 -55 -53 -55 -55 -53 -55 -55 -55 -79 
-53 -55 -55 -55 -55 -55 -53 -55 -55 -53 
-55 -53 -55 -55 -55 -55 -55 -55 -55 -55 
-55 -55 -55 -55 -55 -55 -55 -53 -55 -55 
-55 -55 -55 -55 -55 -55 -53 -53 -53 -53 
-55 -53 -53 -53 -55 -55 -55 -55 -55 -55 
-55 -53 -55 -55 -55 -55 -55 -55 -55 -55 
-53 -55 -55 -55 -55 -55 -53 -55 -55 -53 
-55 -55 -55 -55 -55 -55 -53 -53 -55 -55 
-55 -53 -55 -55 -55 -55 -55 -55 -55 -55 
-53 -55 -55 -55 -55 -55 -55 -55 -55 -55 
-55 -55 -55 -55 -57 -53 -55 -55 -55 -55 
-55 -55 -55 -57 -55 -55 -53 -55 -55 -55 
-55 -55 -57 -55 -55 -55 -55 -53 -53 -55 
-55 -55 -55 -55 -55 -53 -55 -55 -55 -89 
-55 -53 -55 -55 -55 -53 -55 -57 -55 -55 
-55 -57 -55 -57 -55 -55 -57 -55 -57 -91 
-55 -55 -55 -55 -55 -55 -55 -55 -55 -55 
-55 -55 -55 -55 -55 -55 -55 -55 -55 -55 
-55 -55 -57 -55 -57 -55 -55 -55 -55 -55 
-55 -55 -53 -55 -55 -55 -55 -55 -55 -55 
-57 -57 -55 -57 -57 -55 -57 -55 -57 -55 
-55 -55 -57 -55 -57 -59 -55 -57 -55 -55 
-55 -55 -55 -55 -61 -61 -55 -57 -55 -55 
-55 -55 -55 -55 -55 -55 -55 -55 -55 -55 
-57 -55 -55 -55 -55 -55 -55 -57 -55 -55 
-55 -55 -61 -55 -53 -55 -57 -57 -55 -55 
-57 -55 -55 -55 -55 -55 -55 -55 -55 -55 
-57 -55 -57 -55 -55 -55 -57 -55 -57 -55 
-55 -55 -57 -55 -55 -55 -55 -55 -57 -55 
-55 -55 -55 -57 -55 -55 -57 -55 -55 -55 
-55 -55 -55 -55 -57 -55 -55 -55 -55 -55 
-55 -55 -55 -53 -55 -53 -53 -53 -55 -55 
-55 -55 -53 -55 -55 -55 -55 -55 -55 -55 
-55 -55 -55 -53 -55 -53 -55 -53 -55 -55 
-55 -55 -55 -57 -55 -55 -57 -55 -55 -55 
-55 -55 -55 -55 -55 -55 -55 -55 -55 -55 
-55 -55 -55 -57 -55 -55 -55 -55 -55 -55 
-55 -55 -55 -55 -55 -55 -55 -55 -55 -55 
-55 -57 -55 -55 -55 -55 -57 -55 -57 -55 
-55 -55 -55 -57 -55 -55 -55 -55 -55 -55 
-55 -55 -57 -55 -55 -55 -55 -55 -55 -55 
-55 -55 -55 -55 -55 -57 -57 -55 -57 -55 
-55 -55 -53 -55 -55 -57 -55 -55 -55 -57 
-55 -55 -55 -55 -57 -57 -55 -55 -55 -55 
-55 -55 -55 -55 -57 -55 -53 -55 -91 -55 
-55 -57 -57 -55 -55 -57 -55 -57 -55 -55 
-55 -55 -57 -91 -57 -55 -53 -55 -55 -55 
-57 -55 -57 -55 -55 -55 -55 -55 -55 -55 
-55 -55 -55 -55 -55 -55 -55 -55 -55 -79 
-55 -57 -55 -55 -55 -55 -55 -55 -55 -53 
-55 -55 -55 -53 -55 -55 -55 -53 -55 -55 
-55 -57 -57 -55 -57 -55 -55 -55 -55 -57 
-55 -53 -55 -57 -55 -55 -55 -53 -53 -55 
-53 -55 -55 -53 -55 -55 -55 -53 -55 -57 
-55 -53 -55 -55 -55 -55 -55 -55 -55 -55 
-55 -55 -53 -55 -55 -55 -55 -55 -55 -57 
-55 -55 -53 -55 -55 -55 -55 -55 -55 -57 
-55 -55 -55 -55 -53 -55 -55 -91 -91 -55 
-55 -55 -55 -55 -55 -55 -55 -55 -55 -55 
-55 -55 -55 -55 -55 -55 -55 -53 -55 -55 
