
-43 -45 -45 -45 -45 -45 -45 -45 -45 -47 
-47 -45 -45 -47 -45 -47 -43 -45 -45 -45 
-45 -45 -45 -43 -43 -43 -43 -45 -45 -47 
-45 -47 -45 -45 -45 -43 -47 -45 -47 -45 
-45 -47 -45 -47 -45 -45 -47 -45 -43 -47 
-47 -47 -47 -45 -45 -47 -45 -45 -45 -45 
-45 -45 -45 -45 -45 -43 -43 -45 -45 -45 
-45 -45 -47 -47 -43 -43 -43 -45 -45 -47 
-45 -45 -45 -45 -45 -45 -47 -45 -45 -45 
-45 -45 -43 -45 -45 -45 -45 -45 -43 -47 
-43 -45 -45 -47 -45 -47 -45 -47 -45 -45 
-45 -45 -45 -45 -45 -47 -45 -45 -45 -43 
-45 -47 -45 -45 -47 -45 -45 -47 -45 -45 
-45 -45 -45 -45 -45 -45 -43 -45 -45 -45 
-45 -47 -45 -47 -47 -45 -45 -45 -45 -45 
-45 -91 -45 -45 -45 -45 -45 -45 -45 -45 
-47 -45 -45 -45 -45 -45 -45 -45 -47 -45 
-47 -45 -45 -45 -47 -45 -45 -45 -45 -47 
-45 -47 -45 -47 -45 -47 -45 -47 -45 -47 
-45 -45 -45 -45 -45 -45 -45 -47 -47 -45 
-45 -45 -45 -47 -45 -43 -45 -45 -45 -93 
-43 -45 -47 -45 -43 -45 -45 -47 -47 -45 
-47 -49 -45 -47 -45 -45 -45 -45 -43 -45 
-45 -45 -45 -47 -45 -45 -45 -45 -45 -47 
-47 -45 -45 -45 -43 -47 -47 -47 -45 -45 
-45 -45 -45 -47 -45 -45 -45 -47 -47 -45 
-45 -45 -45 -47 -45 -45 -47 -47 -45 -47 
-47 -45 -47 -45 -45 -45 -45 -45 -45 -45 
-45 -47 -45 -45 -45 -47 -45 -47 -45 -45 
-45 -45 -45 -43 -47 -47 -47 -45 -45 -45 
-45 -47 -47 -45 -47 -45 -47 -45 -45 -45 
-45 -45 -43 -45 -45 -45 -45 -47 -45 -47 
-45 -47 -45 -45 -45 -45 -45 -45 -45 -45 
-45 -45 -45 -45 -45 -45 -47 -45 -45 -45 
-47 -91 -45 -47 -47 -45 -45 -45 -45 -47 
-45 -43 -45 -45 -45 -45 -45 -47 -45 -45 
-45 -43 -45 -45 -45 -45 -45 -45 -43 -47 
-45 -45 -47 -45 -45 -45 -47 -47 -45 -45 
-45 -47 -45 -45 -45 -45 -45 -43 -45 -45 
-47 -45 -45 -47 -43 -45 -45 -45 -47 -47 
-47 -45 -45 -47 -43 -45 -45 -47 -45 -45 
-47 -47 -45 -45 -45 -45 -47 -45 -47 -45 
-47 -47 -45 -45 -45 -47 -45 -47 -45 -45 
-45 -45 -45 -45 -45 -45 -45 -45 -45 -43 
-45 -47 -45 -43 -45 -47 -47 -47 -47 -47 
-47 -43 -45 -47 -45 -45 -45 -45 -47 -45 
-45 -45 -45 -45 -45 -43 -45 -47 -45 -45 
-47 -47 -45 -45 -47 -45 -45 -47 -45 -45 
-47 -47 -45 -47 -45 -45 -47 -45 -45 -45 
-43 -47 -47 -47 -45 -45 -45 -45 -43 -47 
-45 -45 -47 -45 -45 -43 -45 -45 -45 -45 
-45 -45 -45 -45 -45 -45 -47 -45 -47 -47 
-45 -47 -45 -45 -45 -43 -47 -45 -45 -47 
-47 -47 -47 -45 -43 -45 -45 -47 -45 -47 
-45 -45 -45 -45 -45 -45 -47 -47 -47 -45 
-45 -45 -47 -45 -45 -45 -45 -45 -45 -45 
-45 -45 -45 -47 -43 -45 -45 -45 -45 -47 
-45 -45 -47 -47 -45 -45 -45 -45 -45 -43 
-47 -45 -45 -47 -47 -45 -47 -45 -45 -45 
-45 -45 -45 -45 -45 -45 -45 -45 -47 -45 
-45 -45 -45 -45 -45 -45 -45 -45 -47 -47 
-47 -47 -47 -45 -45 -47 -47 -47 -45 -45 
-45 -45 -45 -47 -43 -45 -45 -45 -45 -45 
-45 -45 -45 -45 -45 -47 -43 -47 -45 -45 
-45 -45 -45 -45 -45 -47 -45 -45 -45 -47 
-45 -45 -47 -47 -47 -45 -45 -47 -47 -47 
-43 -47 -45 -45 -43 -47 -45 -47 -45 -45 
-45 -47 -45 -45 -45 -47 -47 -45 -47 -45 
-45 -47 -47 -45 -47 -45 -47 -45 -47 -45 
-45 -47 -45 -45 -45 -45 -47 -45 -45 -47 
-45 -45 -45 -45 -45 -45 -45 -47 -45 -45 
-45 -43 -45 -43 -45 -45 -47 -47 -45 -45 
-45 -45 -47 -47 -45 -45 -45 -47 -45 -47 
-45 -45 -45 -45 -47 -45 -45 -45 -45 -45 
-45 -45 -47 -47 -45 -45 -45 -45 -47 -47 
-45 -47 -45 -45 -47 -47 -47 -45 -43 -45 
-47 -45 -45 -47 -45 -45 -43 -47 -47 -47 
-45 -47 -45 -47 -45 -43 -45 -45 -45 -43 
-47 -45 -45 -47 -45 -45 -47 -45 -47 -45 
-45 -45 -45 -47 -45 -45 -47 -45 -45 -45 
-47 -91 -45 -45 -45 -47 -45 -91 -45 -45 
-45 -45 -47 -47 -45 -45 -47 -47 -47 -47 
-45 -45 -47 -47 -47 -45 -45 -45 -43 -47 
-45 -47 -45 -47 -45 -45 -47 -43 -45 -45 
-45 -45 -47 -45 -43 -45 -45 -45 -45 -47 
-45 -45 -47 -45 -45 -45 -47 -45 -47 -47 
-45 -93 -45 -45 -43 -47 -47 -45 -47 -45 
-45 -47 -43 -47 -45 -45 -47 -45 -43 -47 
-45 -47 -47 -43 -47 -47 -45 -45 -47 -45 
-45 -45 -45 -45 -45 -45 -45 -47 -47 -45 
-91 -45 -45 -47 -45 -47 -45 -47 -45 -43 
-45 -47 -47 -47 -45 -45 -47 -45 -45 -47 
-47 -45 -45 -45 -45 -45 -45 -45 -47 -45 
-45 -45 -45 -47 -43 -45 -45 -45 -45 -47 
-45 -45 -47 -45 -45 -45 -45 -47 -45 -43 
-45 -47 -45 -47 -45 -45 -47 -45 -43 -47 
-45 -45 -45 -47 -43 -45 -45 -45 -47 -45 
-45 -45 -45 -45 -45 -45 -47 -45 -45 -45 
-45 -45 -45 -45 -45 -47 -45 -45 -45 -47 
-45 -45 -47 -47 -47 -45 -45 -47 -45 -45 
