
-43 -45 -43 -43 -45 -45 -45 -43 -45 -45 
-43 -43 -43 -45 -43 -43 -45 -43 -45 -43 
-43 -43 -43 -43 -43 -45 -43 -45 -45 -43 
-45 -43 -45 -43 -45 -43 -45 -45 -47 -45 
-45 -43 -45 -45 -45 -43 -45 -43 -45 -45 
-45 -45 -45 -43 -43 -45 -43 -47 -45 -47 
-43 -45 -47 -45 -47 -43 -45 -43 -45 -45 
-45 -45 -45 -43 -43 -45 -43 -43 -43 -45 
-43 -43 -45 -43 -43 -43 -43 -45 -45 -43 
-41 -43 -45 -43 -41 -43 -43 -43 -43 -41 
-45 -43 -43 -91 -45 -43 -45 -41 -43 -43 
-41 -41 -43 -41 -43 -43 -43 -43 -45 -41 
-43 -43 -45 -43 -45 -43 -45 -43 -43 -41 
-43 -43 -45 -43 -43 -43 -41 -43 -43 -45 
-43 -43 -43 -41 -43 -43 -45 -43 -43 -43 
-43 -43 -43 -43 -43 -45 -43 -43 -43 -45 
-43 -43 -43 -43 -43 -45 -45 -45 -87 -87 
-43 -43 -91 -45 -43 -45 -45 -43 -43 -45 
-45 -45 -45 -47 -43 -43 -45 -43 -43 -41 
-45 -43 -43 -43 -43 -45 -45 -43 -45 -43 
-45 -43 -45 -47 -47 -43 -43 -45 -45 -47 
-43 -45 -43 -43 -45 -45 -45 -45 -45 -43 
-43 -43 -43 -43 -45 -45 -45 -43 -43 -43 
-45 -43 -45 -43 -43 -43 -43 -45 -43 -43 
-43 -43 -43 -45 -41 -43 -43 -43 -43 -45 
-43 -43 -43 -45 -43 -45 -41 -43 -43 -45 
-45 -43 -45 -45 -45 -45 -43 -45 -43 -43 
-43 -45 -43 -43 -43 -45 -45 -45 -43 -43 
-43 -43 -43 -49 -47 -45 -43 -45 -43 -45 
-43 -43 -41 -43 -43 -43 -43 -43 -45 -45 
-43 -43 -45 -43 -45 -45 -43 -43 -45 -43 
-43 -43 -45 -45 -43 -43 -43 -43 -43 -43 
-45 -43 -77 -43 -43 -43 -43 -43 -43 -43 
-43 -43 -45 -43 -45 -43 -43 -45 -43 -43 
-43 -43 -45 -45 -45 -45 -43 -43 -45 -43 
-45 -45 -45 -45 -45 -43 -43 -43 -45 -43 
-45 -45 -43 -43 -43 -43 -45 -45 -45 -45 
-41 -45 -43 -45 -43 -45 -43 -43 -45 -43 
-43 -45 -45 -43 -45 -43 -43 -45 -45 -43 
-43 -45 -45 -43 -45 -43 -43 -43 -45 -43 
-45 -45 -45 -43 -43 -45 -45 -45 -43 -45 
-41 -45 -45 -45 -45 -43 -45 -45 -45 -43 
-45 -45 -43 -45 -45 -87 -43 -43 -45 -43 
-45 -45 -45 -45 -43 -43 -43 -45 -43 -45 
-45 -43 -43 -43 -45 -43 -43 -45 -45 -43 
-45 -45 -43 -45 -43 -43 -43 -45 -45 -45 
-43 -45 -43 -45 -45 -45 -43 -45 -45 -43 
-45 -45 -45 -43 -45 -43 -45 -43 -45 -45 
-45 -45 -45 -43 -45 -43 -45 -43 -45 -43 
-45 -45 -45 -43 -43 -45 -43 -45 -43 -45 
-45 -45 -43 -43 -45 -43 -43 -43 -43 -45 
-45 -43 -43 -43 -43 -45 -45 -43 -45 -43 
-45 -45 -43 -45 -43 -45 -45 -45 -43 -45 
-43 -45 -43 -45 -45 -45 -43 -43 -45 -45 
-45 -45 -45 -43 -43 -43 -45 -43 -43 -43 
-43 -43 -45 -43 -43 -45 -45 -73 -43 -43 
-43 -43 -43 -43 -45 -91 -45 -45 -45 -45 
-45 -45 -43 -41 -43 -91 -43 -43 -41 -45 
-45 -43 -45 -43 -45 -43 -45 -43 -45 -43 
-43 -45 -45 -45 -43 -45 -45 -43 -45 -43 
-43 -45 -43 -45 -43 -45 -45 -45 -43 -45 
-43 -45 -45 -45 -43 -45 -43 -45 -43 -45 
-43 -45 -43 -45 -43 -43 -45 -45 -43 -43 
-45 -43 -45 -43 -65 -65 -45 -45 -43 -43 
-43 -43 -43 -45 -43 -45 -43 -45 -43 -43 
-43 -43 -43 -43 -45 -43 -43 -45 -41 -45 
-45 -45 -43 -43 -45 -43 -43 -45 -43 -45 
-45 -45 -43 -45 -43 -43 -43 -43 -45 -43 
-43 -43 -43 -43 -45 -41 -45 -43 -45 -43 
-45 -43 -45 -45 -43 -41 -43 -45 -45 -43 
-43 -43 -45 -45 -41 -45 -43 -45 -43 -45 
-41 -43 -43 -43 -45 -45 -43 -45 -45 -45 
-43 -43 -41 -45 -43 -45 -45 -45 -43 -45 
-41 -45 -41 -43 -45 -41 -43 -43 -43 -45 
-43 -43 -43 -45 -43 -45 -43 -45 -45 -45 
-43 -45 -43 -43 -43 -45 -43 -43 -43 -45 
-41 -45 -43 -43 -43 -43 -43 -45 -43 -43 
-45 -45 -45 -45 -43 -45 -43 -45 -43 -45 
-43 -45 -45 -45 -45 -45 -41 -43 -43 -45 
-45 -45 -45 -45 -49 -45 -45 -45 -43 -45 
-43 -43 -45 -45 -43 -43 -45 -43 -45 -43 
-45 -43 -43 -45 -45 -43 -43 -43 -43 -43 
-45 -43 -43 -43 -45 -45 -43 -43 -45 -43 
-47 -47 -45 -43 -43 -45 -45 -45 -45 -43 
-45 -45 -43 -45 -43 -45 -45 -45 -45 -43 
-43 -43 -43 -43 -43 -45 -45 -43 -45 -43 
-45 -43 -45 -43 -45 -43 -45 -43 -45 -45 
-45 -45 -43 -45 -45 -45 -43 -43 -43 -45 
-43 -43 -43 -43 -43 -43 -43 -43 -43 -43 
-71 -45 -43 -43 -43 -43 -43 -43 -45 -43 
-45 -43 -43 -41 -43 -45 -45 -43 -45 -45 
-43 -43 -45 -43 -45 -43 -43 -43 -45 -43 
-45 -45 -45 -45 -43 -43 -43 -45 -43 -43 
-45 -45 -45 -45 -45 -43 -45 -43 -45 -43 
-45 -43 -45 -43 -43 -43 -45 -43 -45 -85 
-45 -45 -43 -43 -43 -45 -43 -43 -43 -45 
-45 -45 -45 -91 -43 -45 -43 -45 -45 -43 
-43 -43 -45 -45 -43 -41 -45 -45 -45 -43 
-45 -43 -45 -43 -43 -43 -45 -45 -45 -45 
-43 -45 -43 -43 -43 -45 -45 -43 -43 -43 
