-53 -55 -55 -53 -53 -53 -53 -53 -51 -53 
-53 -51 -55 -53 -55 -53 -53 -53 -53 -53 
-55 -53 -53 -53 -53 -53 -51 -53 -51 -51 
-51 -51 -51 -51 -51 -51 -51 -51 -51 -51 
-51 -51 -49 -51 -51 -51 -51 -51 -51 -51 
-51 -53 -53 -53 -51 -53 -51 -53 -51 -51 
-51 -51 -51 -53 -53 -53 -55 -53 -55 -55 
-53 -53 -53 -53 -55 -53 -55 -55 -55 -53 
-53 -53 -55 -55 -53 -53 -55 -53 -55 -53 
-53 -53 -53 -53 -53 -53 -53 -53 -51 -55 
-53 -53 -55 -53 -53 -53 -53 -53 -53 -53 
-53 -53 -53 -51 -51 -51 -51 -53 -55 -53 
-53 -55 -57 -53 -55 -55 -53 -53 -55 -53 
-55 -55 -55 -55 -57 -57 -51 -51 -53 -53 
-53 -53 -53 -55 -51 -51 -53 -51 -51 -51 
-51 -51 -51 -53 -53 -53 -51 -51 -51 -51 
-51 -51 -51 -49 -51 -51 -49 -51 -53 -53 
-51 -51 -51 -51 -51 -51 -51 -53 -51 -51 
-51 -51 -51 -51 -51 -51 -51 -51 -51 -51 
-51 -51 -49 -51 -51 -51 -51 -51 -51 -51 
-51 -49 -51 -49 -49 -51 -51 -51 -49 -51 
-51 -51 -51 -51 -51 -51 -51 -51 -51 -53 
-53 -51 -51 -51 -51 -53 -53 -51 -51 -51 
-51 -53 -51 -51 -51 -51 -49 -51 -51 -51 
-49 -51 -49 -51 -51 -51 -51 -51 -49 -51 
-49 -51 -51 -51 -51 -51 -49 -51 -51 -51 
-51 -51 -51 -51 -53 -51 -51 -51 -51 -51 
-51 -51 -51 -51 -51 -51 -49 -51 -49 -51 
-51 -51 -51 -51 -51 -49 -49 -51 -51 -51 
-51 -51 -51 -51 -51 -51 -51 -51 -51 -51 
-51 -51 -51 -51 -51 -51 -51 -49 -51 -51 
-51 -51 -51 -49 -51 -51 -51 -49 -51 -51 
-53 -49 -51 -51 -51 -51 -51 -49 -51 -51 
-51 -51 -51 -51 -51 -51 -51 -51 -51 -51 
-51 -51 -51 -51 -51 -51 -51 -51 -51 -51 
-51 -51 -51 -51 -51 -51 -51 -51 -49 -51 
-51 -51 -51 -51 -51 -51 -51 -51 -49 -51 
-51 -51 -51 -51 -51 -51 -51 -51 -51 -51 
-51 -51 -51 -49 -51 -51 -51 -51 -51 -51 
-51 -51 -51 -51 -51 -51 -49 -51 -49 -51 
-51 -51 -51 -51 -49 -51 -51 -51 -51 -51 
-51 -51 -51 -51 -51 -51 -49 -51 -51 -51 
-51 -51 -51 -51 -51 -51 -51 -51 -51 -51 
-51 -51 -51 -51 -51 -51 -51 -51 -49 -51 
-51 -51 -51 -51 -51 -49 -51 -51 -51 -49 
-51 -51 -51 -51 -51 -51 -51 -51 -51 -51 
-51 -49 -51 -49 -51 -51 -51 -51 -51 -51 
-51 -51 -51 -51 -49 -51 -49 -51 -51 -51 
-49 -51 -51 -51 -51 -51 -51 -51 -51 -51 
-51 -51 -51 -51 -51 -51 -51 -51 -51 -51 
-51 -51 -49 -51 -51 -51 -51 -51 -51 -51 
-51 -51 -49 -51 -49 -51 -51 -51 -51 -51 
-49 -51 -51 -51 -51 -51 -51 -51 -51 -51 
-51 -51 -51 -49 -51 -51 -51 -49 -51 -51 
-51 -51 -51 -49 -53 -51 -51 -49 -51 -51 
-51 -51 -51 -51 -51 -51 -49 -51 -51 -51 
-49 -51 -51 -51 -51 -51 -51 -51 -51 -51 
-51 -51 -51 -51 -51 -51 -51 -49 -51 -51 
-51 -51 -49 -49 -53 -49 -51 -51 -51 -51 
-51 -49 -51 -51 -51 -51 -51 -51 -51 -51 
-51 -51 -51 -51 -51 -51 -51 -51 -51 -51 
-51 -51 -51 -51 -51 -51 -51 -51 -51 -51 
-51 -51 -51 -51 -51 -51 -51 -51 -51 -49 
-51 -51 -51 -51 -51 -51 -51 -51 -51 -51 
-91 -51 -51 -49 -49 -51 -51 -51 -51 -51 
-51 -51 -49 -51 -51 -51 -51 -51 -51 -51 
-51 -51 -51 -51 -51 -51 -51 -51 -51 -51 
-51 -51 -51 -51 -51 -51 -51 -51 -49 -51 
-51 -51 -51 -51 -49 -51 -51 -51 -51 -51 
-51 -51 -49 -51 -51 -49 -51 -51 -51 -49 
-51 -51 -51 -49 -49 -51 -51 -51 -51 -51 
-49 -51 -49 -51 -51 -51 -51 -51 -51 -51 
-51 -51 -51 -51 -51 -51 -51 -51 -51 -51 
-51 -51 -51 -51 -51 -51 -51 -51 -51 -51 
-51 -51 -49 -51 -51 -51 -51 -51 -51 -51 
-51 -51 -51 -51 -51 -51 -51 -51 -51 -51 
-51 -51 -51 -51 -51 -51 -51 -51 -51 -51 
-51 -51 -91 -51 -51 -51 -51 -51 -51 -51 
-49 -51 -51 -51 -51 -49 -51 -51 -51 -51 
-51 -49 -51 -51 -51 -49 -51 -51 -49 -51 
-51 -51 -51 -51 -51 -49 -51 -51 -51 -51 
-51 -51 -51 -51 -51 -51 -51 -49 -51 -51 
-51 -51 -51 -51 -49 -51 -49 -49 -51 -49 
-51 -51 -51 -51 -51 -51 -51 -51 -51 -51 
-51 -51 -51 -51 -51 -51 -49 -51 -51 -91 
-51 -51 -51 -51 -51 -51 -51 -51 -51 -51 
-51 -51 -51 -51 -51 -51 -51 -49 -51 -51 
-51 -51 -49 -51 -51 -51 -51 -51 -51 -51 
-51 -51 -51 -51 -51 -51 -89 -51 -49 -51 
-51 -51 -51 -51 -51 -51 -51 -51 -51 -51 
-49 -49 -51 -51 -51 -51 -51 -51 -51 -51 
-51 -49 -51 -51 -51 -51 -51 -51 -51 -51 
-51 -51 -51 -51 -51 -51 -49 -51 -49 -51 
-51 -51 -49 -51 -51 -51 -49 -49 -53 -49 
-51 -53 -51 -49 -51 -51 -51 -51 -51 -51 
-51 -51 -51 -51 -51 -51 -51 -51 -51 -51 
-51 -51 -51 -51 -51 -51 -51 -49 -51 -51 
-51 -51 -51 -49 -51 -51 -51 -51 -51 -51 
-49 -51 -51 -51 -51 -51 -51 -51 -51 -49 
-49 -51 -51 -49 -49 -49 -51 -49 -51 -51 
-51 -51 -51 -49 -49 -49 -51 -49 -49 -49 
-51 -49 -51 -51 -51 -49 -51 -49 -51 -51 
-51 -51 -51 -51 -51 -51 -51 -51 -51 -49 
-51 -51 -51 -51 -51 -51 -51 -51 -51 -51 
-51 -51 -51 -51 -51 -49 -51 -51 -51 -51 
-51 -51 -51 -51 -51 -51 -51 -51 -51 -51 
-51 -51 -51 -93 -51 -51 -51 -51 -51 -51 
-51 -51 -51 -51 -51 -51 -51 -51 -49 -51 
-51 -51 -51 -51 -51 -51 -51 -51 -51 -51 
-51 -51 -51 -51 -49 -51 -51 -51 -51 -51 
-51 -51 -51 -51 -51 -51 -51 -51 -51 -51 
-49 -51 -51 -51 -49 -51 -51 -51 -51 -51 
-51 -51 -51 -51 -51 -51 -53 -51 -51 -51 
-51 -51 -51 -51 -51 -51 -51 -51 -51 -51 
-51 -53 -51 -51 -51 -51 -51 -51 -51 -51 
-53 -51 -51 -51 -51 -53 -51 -51 -49 -49 
-53 -53 -51 -51 -53 -51 -53 -51 -53 -53 
-53 -51 -51 -51 -51 -51 -53 -53 -55 -55 
-55 -55 -53 -53 -53 -55 -53 -55 -53 -55 
-55 -55 -53 -53 -55 -53 -55 -55 -53 -55 
-53 -55 -53 -51 -53 -55 -55 -55 -57 -57 
-57 -57 -59 -57 -59 -59 -59 -57 -57 -55 
-57 -55 -57 -57 -59 -57 -59 -57 -57 -59 
-57 -57 -59 -57 -59 -57 -59 -59 -59 -57 
-59 -57 -59 -57 -59 -57 -59 -59 -59 -57 
-59 -57 -59 -57 -59 -57 -57 -57 -59 -57 
-57 -57 -57 -55 -51 -53 -51 -51 -51 -53 
-53 -53 -53 -53 -51 -51 -51 -53 -53 -53 
-51 -53 -53 -53 -51 -51 -53 -53 -51 -55 
-53 -53 -55 -55 -55 -55 -57 -55 -53 -51 
-51 -51 -51 -51 -51 -51 -53 -53 -53 -55 
-55 -55 -53 -55 -55 -55 -53 -55 -53 -55 
-55 -53 -53 -55 -55 -55 -57 -53 -55 -55 
-53 -53 -53 -53 -51 -51 -53 -51 -51 -51 
-51 -51 -51 -51 -51 -51 -53 -51 -53 -53 
-53 -53 -51 -51 -51 -49 -51 -49 -51 -49 
-49 -51 -49 -49 -51 -49 -51 -51 -51 -51 
-53 -55 -55 -55 -53 -53 -55 -53 -53 -53 
-53 -55 -55 -53 -51 -51 -53 -53 -53 -53 
-53 -51 -51 -51 -51 -51 -51 -51 -49 -49 
-49 -49 -49 -51 -51 -51 -51 -49 -51 -49 
-49 -49 -49 -49 -47 -47 -49 -49 -49 -49 
-49 -49 -49 -49 -51 -49 -49 -49 -49 -47 
-49 -49 -49 -47 -49 -49 -49 -49 -49 -49 
-49 -51 -51 -49 -51 -51 -49 -91 -49 -51 
-51 -51 -49 -51 -51 -51 -51 -51 -51 -51 
-51 -51 -49 -51 -49 -51 -51 -51 -51 -51 
-49 -51 -49 -51 -51 -49 -49 -51 -51 -51 
-51 -51 -51 -51 -51 -51 -51 -51 -53 -53 
-51 -51 -51 -51 -51 -51 -49 -49 -49 -51 
-51 -49 -49 -51 -51 -51 -51 -49 -51 -51 
-51 -51 -49 -51 -51 -51 -51 -51 -51 -51 
-51 -51 -53 -51 -53 -53 -53 -53 -53 -51 
-53 -51 -51 -53 -51 -53 -51 -51 -53 -51 
-51 -53 -51 -53 -51 -51 -51 -53 -53 -51 
-53 -53 -51 -51 -51 -51 -53 -51 -53 -51 
-51 -51 -53 -51 -51 -51 -51 -53 -51 -51 
-51 -49 -51 -49 -51 -49 -51 -51 -51 -51 
-51 -51 -51 -51 -51 -51 -51 -51 -51 -53 
-51 -51 -49 -51 -51 -51 -51 -51 -51 -91 
-51 -51 -51 -51 -51 -49 -49 -51 -51 -51 
-51 -51 -51 -51 -51 -53 -51 -51 -51 -51 
-51 -51 -51 -51 -49 -49 -51 -51 -49 -51 
-51 -51 -51 -51 -51 -51 -51 -51 -51 -51 
-51 -51 -51 -51 -51 -51 -51 -51 -51 -51 
-51 -51 -51 -49 -51 -51 -51 -51 -49 -51 
-51 -51 -51 -51 -51 -51 -51 -51 -49 -51 
-51 -49 -51 -51 -49 -51 -49 -51 -51 -51 
-51 -51 -53 -51 -53 -51 -53 -51 -53 -51 
-51 -51 -51 -51 -51 -51 -51 -51 -51 -51 
-49 -51 -89 -51 -51 -51 -51 -53 -51 -49 
-51 -49 -51 -51 -51 -49 -51 -51 -53 -51 
-49 -49 -51 -51 -51 -51 -49 -51 -51 -51 
-51 -51 -51 -51 -49 -51 -51 -49 -51 -51 
-51 -51 -51 -51 -51 -51 -49 -51 -51 -51 
-51 -51 -51 -51 -51 -51 -51 -51 -51 -51 
-51 -51 -51 -51 -51 -51 -51 -51 -51 -51 
-51 -51 -51 -51 -51 -49 -51 -51 -51 -51 
-51 -51 -49 -51 -49 -51 -51 -51 -51 -51 
-51 -49 -51 -51 -51 -51 -51 -51 -51 -51 
-53 -51 -51 -51 -51 -51 -51 -51 -49 -51 
-51 -51 -51 -51 -51 -51 -49 -51 -91 -91 
-51 -51 -51 -51 -51 -51 -51 -49 -51 -51 
-51 -51 -49 -51 -51 -51 -51 -51 -51 -51 
-51 -51 -51 -51 -51 -51 -51 -51 -49 -49 
-51 -51 -51 -51 -51 -49 -49 -51 -51 -51 
-51 -51 -51 -51 -51 -51 -51 -51 -51 -51 
-49 -51 -51 -51 -51 -51 -51 -51 -51 -51 
-51 -51 -51 -51 -51 -51 -51 -51 -51 -51 
-51 -51 -51 -49 -51 -51 -51 -51 -51 -51 
-49 -51 -51 -51 -51 -51 -51 -49 -51 -51 
-51 -91 -51 -51 -51 -51 -51 -51 -51 -51 
-51 -51 -51 -51 -51 -49 -51 -51 -51 -51 
-51 -49 -51 -51 -51 -49 -51 -51 -51 -51 
-51 -51 -51 -49 -51 -51 -49 -51 -51 -51 
-51 -51 -51 -51 -51 -51 -51 -51 -49 -51 
-51 -49 -51 -51 -49 -51 -51 -51 -51 -51 
-49 -51 -51 -51 -51 -51 -51 -51 -51 -51 
-49 -51 -51 -51 -51 -51 -51 -51 -51 -51 
-51 -51 -51 -51 -51 -51 -51 -51 -51 -51 
-51 -49 -51 -51 -51 -51 -49 -51 -51 -51 
-49 -51 -51 -53 -51 -49 -49 -51 -51 -51 
-51 -51 -51 -51 -51 -51 -51 -91 -51 -51 
-51 -49 -49 -51 -51 -51 -51 -51 -51 -51 
-51 -51 -53 -51 -49 -49 -51 -49 -51 -51 
-51 -51 -51 -51 -51 -51 -51 -53 -51 -91 
-51 -51 -51 -51 -51 -49 -51 -51 -51 -51 
-49 -51 -49 -49 -51 -51 -51 -51 -51 -53 
-49 -49 -51 -51 -49 -47 -51 -51 -51 -51 
-51 -51 -51 -51 -51 -53 -53 -51 -51 -51 
-51 -51 -51 -49 -51 -51 -51 -51 -51 -53 
-51 -51 -51 -49 -53 -51 -51 -49 -51 -51 
-51 -49 -53 -53 -51 -49 -49 -51 -53 -51 
-51 -51 -49 -51 -51 -49 -49 -49 -49 -51 
-53 -51 -51 -49 -49 -49 -49 -49 -51 -49 
-49 -53 -53 -53 -51 -51 -53 -53 -53 -55 
-53 -55 -57 -57 -57 -55 -51 -53 -51 -51 
-53 -51 -51 -51 -51 -51 -53 -51 -51 -49 
-49 -49 -51 -51 -51 -51 -49 -47 -53 -55 
-53 -53 -51 -51 -49 -49 -49 -51 -49 -51 
-51 -51 -51 -49 -49 -51 -53 -53 -51 -51 
-51 -49 -51 -49 -51 -51 -51 -51 -51 -51 
-81 -49 -51 -51 -49 -49 -51 -51 -51 -49 
-49 -49 -51 -53 -51 -51 -51 -51 -51 -49 
-51 -51 -51 -53 -53 -51 -51 -53 -51 -53 
-51 -51 -51 -51 -51 -51 -53 -53 -51 -53 
-51 -53 -51 -49 -49 -49 -51 -51 -53 -51 
-51 -49 -51 -51 -51 -51 -53 -51 -51 -51 
-51 -53 -51 -51 -51 -51 -49 -49 -49 -51 
-51 -51 -51 -51 -51 -51 -51 -51 -51 -51 
-51 -51 -51 -49 -49 -51 -51 -51 -49 -51 
-51 -51 -49 -51 -49 -51 -51 -51 -49 -51 
-51 -53 -51 -51 -51 -51 -51 -51 -51 -51 
-51 -51 -51 -51 -49 -51 -51 -51 -49 -51 
-49 -51 -51 -51 -51 -51 -51 -51 -51 -49 
-51 -51 -51 -49 -51 -51 -49 -51 -51 -51 
-51 -51 -51 -51 -51 -53 -51 -51 -49 -51 
-51 -51 -91 -51 -91 -51 -51 -49 -49 -51 
-51 -51 -49 -49 -51 -53 -51 -51 -51 -51 
-49 -49 -51 -51 -51 -51 -53 -51 -53 -51 
-51 -49 -51 -51 -51 -49 -51 -49 -49 -51 
-51 -51 -51 -51 -51 -51 -49 -51 -51 -51 
-51 -53 -51 -51 -51 -49 -53 -51 -51 -49 
-51 -51 -51 -49 -53 -51 -51 -51 -51 -51 
-53 -49 -51 -51 -51 -51 -49 -51 -51 -51 
-51 -51 -51 -51 -51 -51 -51 -51 -51 -51 
-51 -51 -49 -51 -51 -51 -51 -51 -51 -51 
-53 -51 -51 -53 -51 -51 -51 -51 -51 -51 
-51 -51 -53 -51 -49 -49 -51 -51 -53 -51 
-53 -53 -51 -51 -91 -51 -51 -51 -51 -51 
-53 -53 -55 -49 -51 -51 -53 -53 -53 -53 
-55 -55 -55 -55 -55 -53 -55 -55 -55 -55 
-55 -55 -55 -55 -53 -55 -55 -55 -57 -55 
-57 -57 -55 -55 -55 -57 -57 -55 -55 -55 
-53 -57 -55 -55 -55 -55 -55 -55 -53 -55 
-55 -55 -57 -55 -55 -55 -55 -55 -53 -55 
-53 -55 -55 -55 -55 -57 -55 -55 -55 -57 
-55 -57 -55 -57 -57 -57 -57 -57 -55 -57 
-57 -57 -55 -57 -57 -55 -55 -57 -55 -57 
-55 -57 -57 -57 -55 -55 -55 -57 -57 -57 
-55 -57 -57 -55 -57 -57 -55 -55 -55 -55 
-57 -55 -55 -55 -55 -55 -53 -55 -55 -57 
-55 -55 -55 -55 -55 -57 -55 -57 -55 -57 
-55 -57 -55 -57 -55 -57 -57 -55 -57 -55 
-53 -53 -53 -55 -55 -55 -53 -55 -55 -55 
-55 -55 -55 -55 -55 -55 -57 -55 -55 -55 
-55 -55 -53 -53 -55 -55 -55 -55 -55 -53 
-55 -55 -55 -55 -55 -55 -55 -55 -55 -53 
-55 -55 -53 -55 -55 -55 -55 -55 -55 -55 
-53 -55 -53 -55 -55 -55 -55 -55 -55 -53 
-55 -55 -55 -55 -55 -55 -55 -55 -51 -55 
-55 -53 -53 -55 -55 -55 -55 -53 -55 -57 
-57 -55 -87 -57 -57 -55 -57 -55 -55 -53 
-55 -53 -55 -53 -53 -53 -53 -53 -53 -53 
-55 -55 -55 -53 -55 -53 -55 -55 -57 -55 
-57 -55 -55 -55 -55 -53 -53 -53 -53 -55 
-55 -55 -55 -55 -53 -53 -55 -55 -55 -57 
-57 -55 -55 -55 -55 -55 -53 -55 -53 -51 
-55 -55 -55 -55 -53 -53 -91 -53 -53 -53 
-55 -53 -53 -51 -53 -51 -49 -51 -51 -51 
-51 -51 -53 -51 -51 -49 -51 -51 -51 -49 
-51 -51 -51 -53 -51 -51 -51 -51 -51 -51 
-51 -51 -51 -51 -51 -51 -51 -51 -51 -51 
-51 -51 -51 -49 -49 -51 -49 -51 -51 -51 
-51 -51 -89 -51 -51 -49 -51 -51 -51 -51 
-51 -51 -51 -51 -51 -51 -51 -51 -51 -51 
-51 -51 -53 -51 -51 -51 -51 -51 -51 -51 
-51 -51 -51 -51 -51 -51 -49 -49 -51 -51 
-49 -51 -51 -51 -51 -51 -53 -51 -53 -51 
-51 -51 -51 -51 -51 -51 -51 -51 -51 -51 
-49 -51 -51 -51 -49 -51 -51 -49 -51 -49 
-51 -49 -51 -49 -49 -51 -49 -49 -51 -51 
-51 -51 -51 -51 -51 -51 -49 -51 -49 -49 
-49 -51 -51 -51 -49 -49 -49 -51 -51 -51 
-51 -49 -51 -51 -49 -51 -51 -51 -51 -51 
-51 -51 -49 -49 -51 -51 -51 -51 -51 -51 
-51 -51 -49 -51 -51 -51 -49 -49 -51 -51 
-51 -49 -51 -49 -49 -49 -51 -51 -51 -51 
-51 -51 -49 -49 -51 -51 -49 -49 -49 -49 
-51 -51 -51 -51 -51 -49 -51 -51 -51 -51 
