-61 -61 -61 -61 -61 -59 -61 -61 -59 -61 
-59 -61 -61 -61 -61 -59 -59 -61 -61 -61 
-59 -61 -59 -61 -61 -61 -59 -61 -59 -61 
-59 -59 -59 -59 -59 -59 -59 -59 -59 -57 
-55 -53 -53 -55 -53 -57 -57 -57 -55 -55 
-53 -51 -55 -55 -55 -55 -53 -53 -51 -51 
-51 -49 -51 -49 -51 -51 -55 -55 -53 -53 
-55 -55 -55 -53 -57 -61 -57 -55 -57 -57 
-57 -55 -55 -57 -55 -57 -57 -57 -57 -55 
-57 -55 -53 -53 -53 -53 -51 -51 -51 -91 
-53 -55 -57 -57 -55 -55 -55 -57 -59 -57 
-59 -57 -55 -61 -63 -57 -59 -59 -59 -59 
-59 -55 -55 -57 -57 -55 -57 -55 -55 -55 
-59 -55 -53 -55 -57 -61 -65 -55 -55 -57 
-57 -57 -53 -55 -53 -53 -57 -57 -59 -59 
-55 -57 -59 -59 -57 -61 -59 -59 -57 -57 
-59 -59 -57 -57 -55 -55 -91 -57 -57 -55 
-57 -57 -57 -55 -53 -55 -53 -55 -55 -55 
-55 -57 -57 -55 -59 -57 -57 -57 -55 -53 
-55 -55 -55 -55 -57 -57 -57 -81 -57 -55 
-57 -55 -57 -57 -55 -53 -55 -53 -55 -53 
-57 -55 -55 -53 -57 -57 -57 -55 -55 -53 
-57 -55 -55 -55 -57 -57 -57 -55 -57 -53 
-57 -59 -57 -59 -55 -57 -57 -55 -55 -57 
-59 -63 -55 -57 -61 -63 -57 -55 -59 -59 
-57 -55 -57 -55 -55 -53 -55 -53 -59 -59 
-55 -55 -55 -55 -57 -57 -57 -55 -55 -53 
-55 -59 -61 -57 -55 -55 -55 -55 -57 -55 
-55 -57 -59 -59 -59 -57 -57 -57 -59 -55 
-55 -59 -57 -57 -59 -65 -65 -55 -53 -55 
-53 -55 -55 -53 -53 -51 -51 -53 -53 -53 
-51 -55 -55 -57 -59 -55 -55 -57 -55 -55 
-55 -55 -55 -55 -55 -53 -55 -55 -55 -53 
-53 -53 -53 -55 -55 -55 -55 -55 -55 -53 
-53 -55 -53 -53 -53 -57 -57 -55 -53 -55 
-53 -55 -55 -53 -53 -55 -55 -55 -55 -55 
-55 -57 -53 -55 -53 -55 -55 -57 -55 -57 
-57 -55 -55 -55 -57 -55 -55 -55 -53 -53 
-53 -53 -53 -55 -55 -53 -53 -53 -51 -53 
-55 -53 -53 -53 -53 -55 -53 -53 -53 -53 
-51 -53 -53 -55 -53 -53 -53 -55 -51 -53 
-55 -55 -53 -53 -53 -55 -51 -53 -55 -53 
-53 -53 -53 -53 -53 -55 -53 -55 -51 -55 
-53 -55 -51 -55 -53 -53 -53 -53 -51 -53 
-53 -55 -51 -91 -55 -53 -53 -53 -53 -55 
-53 -51 -53 -53 -91 -53 -53 -53 -53 -53 
-53 -51 -55 -53 -53 -53 -53 -53 -53 -53 
-53 -53 -53 -53 -53 -55 -53 -55 -53 -55 
-53 -55 -53 -53 -51 -53 -53 -55 -53 -55 
-53 -55 -53 -53 -53 -53 -55 -53 -53 -53 
-53 -53 -51 -53 -53 -53 -53 -55 -53 -53 
-53 -55 -53 -53 -53 -55 -53 -53 -51 -53 
-51 -53 -53 -55 -53 -53 -53 -53 -53 -55 
-53 -53 -53 -53 -53 -53 -53 -53 -53 -53 
-79 -55 -51 -53 -53 -55 -51 -53 -53 -53 
-53 -55 -55 -53 -51 -53 -55 -55 -55 -53 
-53 -53 -53 -53 -53 -51 -53 -53 -55 -57 
-57 -59 -57 -55 -57 -55 -59 -59 -59 -59 
-55 -55 -55 -55 -53 -53 -53 -53 -55 -53 
-55 -53 -53 -53 -53 -53 -53 -53 -53 -51 
-53 -55 -53 -55 -57 -55 -55 -57 -59 -55 
-57 -55 -57 -53 -53 -55 -53 -51 -53 -51 
-53 -51 -53 -53 -55 -55 -57 -55 -55 -55 
-57 -57 -61 -61 -55 -55 -55 -61 -59 -59 
-59 -59 -59 -61 -59 -59 -61 -63 -67 -59 
-61 -57 -59 -59 -59 -57 -59 -55 -57 -55 
-57 -57 -57 -55 -53 -55 -55 -55 -55 -89 
-53 -53 -53 -53 -53 -53 -55 -53 -55 -53 
-53 -55 -55 -79 -55 -57 -57 -55 -55 -53 
-53 -53 -51 -53 -53 -53 -55 -55 -59 -63 
-59 -61 -59 -61 -57 -59 -57 -57 -57 -57 
-55 -53 -55 -57 -57 -57 -59 -59 -59 -61 
-57 -59 -61 -63 -61 -57 -59 -57 -59 -57 
-57 -57 -57 -55 -53 -53 -57 -55 -55 -57 
-55 -57 -55 -53 -53 -57 -55 -55 -53 -53 
-55 -53 -55 -53 -51 -51 -55 -53 -53 -53 
-55 -55 -53 -53 -53 -55 -51 -57 -55 -57 
-53 -51 -53 -53 -53 -51 -51 -51 -51 -49 
-51 -51 -53 -51 -53 -51 -55 -53 -53 -53 
-53 -53 -53 -53 -53 -51 -53 -51 -53 -51 
-51 -49 -51 -91 -49 -51 -49 -51 -51 -51 
-49 -51 -51 -51 -49 -51 -51 -51 -49 -51 
-49 -51 -51 -51 -49 -49 -49 -51 -49 -51 
-51 -51 -49 -51 -51 -51 -51 -49 -51 -51 
-51 -51 -49 -49 -51 -91 -49 -49 -51 -51 
-49 -49 -51 -51 -51 -49 -85 -51 -51 -49 
-51 -51 -49 -51 -51 -51 -49 -51 -49 -51 
-49 -51 -49 -51 -51 -53 -51 -51 -51 -51 
-51 -51 -51 -49 -53 -51 -53 -51 -51 -51 
-53 -53 -55 -55 -55 -57 -55 -57 -59 -59 
-57 -59 -57 -57 -57 -55 -57 -57 -57 -55 
-57 -57 -57 -57 -55 -55 -55 -53 -57 -57 
-57 -59 -57 -57 -57 -55 -57 -53 -53 -53 
-53 -91 -95 -59 -59 -57 -59 -59 -59 -57 
-59 -57 -59 -59 -61 -59 -61 -59 -59 -61 
-59 -59 -59 -55 -59 -59 -59 -57 -59 -59 
-59 -57 -57 -59 -59 -59 -59 -59 -59 -57 
-59 -57 -59 -59 -59 -59 -57 -59 -59 -59 
-57 -59 -59 -59 -59 -59 -57 -59 -59 -59 
-59 -57 -57 -57 -57 -57 -55 -57 -57 -57 
-59 -57 -57 -59 -59 -59 -57 -59 -57 -57 
-57 -57 -59 -59 -57 -57 -57 -59 -57 -61 
-59 -57 -53 -55 -55 -55 -55 -57 -57 -55 
-55 -53 -57 -55 -57 -55 -55 -57 -57 -57 
-55 -55 -57 -57 -57 -57 -57 -57 -59 -59 
-59 -59 -53 -53 -53 -55 -55 -57 -55 -57 
-57 -55 -55 -57 -55 -57 -57 -57 -55 -57 
-57 -55 -57 -57 -57 -57 -57 -55 -59 -57 
-57 -57 -57 -57 -55 -55 -55 -55 -57 -55 
-55 -55 -55 -53 -53 -53 -51 -53 -53 -53 
-53 -53 -51 -55 -55 -57 -55 -59 -59 -59 
-59 -59 -61 -59 -57 -55 -59 -57 -63 -63 
-57 -55 -61 -59 -59 -61 -59 -59 -57 -59 
-57 -51 -53 -53 -55 -55 -57 -59 -53 -53 
-51 -51 -51 -51 -51 -51 -51 -55 -55 -57 
-55 -55 -53 -55 -55 -59 -57 -53 -57 -57 
-59 -59 -57 -57 -59 -61 -91 -59 -59 -59 
-59 -59 -55 -55 -57 -59 -57 -57 -57 -59 
-59 -59 -57 -57 -57 -55 -55 -55 -57 -57 
-57 -57 -57 -59 -57 -55 -57 -57 -57 -57 
-57 -57 -55 -57 -57 -57 -59 -57 -57 -55 
-55 -57 -55 -59 -61 -57 -55 -57 -57 -57 
-57 -57 -59 -83 -57 -55 -57 -59 -57 -57 
-55 -55 -57 -55 -59 -57 -53 -55 -57 -57 
-57 -59 -57 -57 -57 -57 -57 -57 -57 -57 
-57 -55 -57 -57 -57 -57 -55 -55 -55 -55 
-55 -57 -55 -55 -55 -57 -57 -55 -55 -57 
-55 -57 -55 -57 -57 -55 -57 -55 -55 -55 
-57 -57 -55 -57 -57 -55 -57 -57 -57 -55 
-57 -57 -55 -57 -57 -57 -55 -57 -57 -57 
-57 -57 -57 -59 -59 -55 -55 -55 -55 -57 
-57 -55 -57 -55 -57 -57 -59 -59 -57 -57 
-57 -57 -57 -55 -59 -59 -57 -59 -61 -55 
-55 -59 -61 -57 -55 -59 -59 -57 -57 -57 
-57 -57 -57 -57 -57 -57 -57 -57 -89 -55 
-53 -59 -59 -55 -55 -55 -57 -57 -57 -59 
-57 -57 -57 -57 -57 -57 -57 -57 -57 -57 
-57 -55 -57 -55 -55 -55 -55 -55 -55 -55 
-55 -53 -55 -55 -55 -55 -55 -55 -55 -55 
-55 -55 -57 -55 -57 -57 -89 -55 -55 -57 
-57 -57 -55 -57 -57 -57 -57 -57 -57 -57 
-59 -57 -57 -55 -57 -57 -57 -57 -57 -57 
-59 -55 -55 -57 -55 -55 -55 -55 -57 -55 
-53 -55 -53 -57 -57 -55 -53 -57 -59 -57 
-59 -57 -57 -91 -59 -51 -59 -59 -59 -59 
-59 -57 -57 -61 -61 -55 -57 -55 -53 -55 
-57 -59 -59 -57 -57 -57 -57 -57 -57 -55 
-57 -57 -57 -57 -55 -57 -57 -57 -91 -57 
-57 -55 -55 -55 -55 -55 -55 -55 -55 -55 
-55 -57 -57 -57 -55 -57 -57 -57 -57 -59 
-61 -57 -55 -55 -57 -57 -57 -57 -57 -57 
-57 -59 -55 -55 -57 -57 -57 -57 -57 -57 
-57 -57 -57 -57 -55 -55 -55 -55 -55 -57 
-55 -55 -55 -55 -55 -57 -55 -55 -57 -57 
-57 -59 -57 -57 -57 -57 -55 -57 -55 -55 
-57 -55 -55 -57 -55 -57 -55 -59 -57 -57 
-55 -55 -55 -55 -57 -57 -57 -55 -57 -57 
-57 -57 -57 -57 -57 -57 -57 -59 -59 -59 
-57 -55 -57 -57 -55 -57 -55 -57 -55 -57 
-55 -57 -57 -55 -57 -57 -57 -55 -55 -57 
-57 -57 -57 -59 -61 -57 -57 -57 -57 -57 
-57 -55 -57 -57 -57 -57 -57 -55 -57 -57 
-57 -57 -57 -57 -57 -57 -55 -57 -57 -57 
-55 -55 -57 -57 -57 -57 -57 -57 -57 -57 
-57 -57 -59 -59 -57 -55 -55 -55 -57 -57 
-57 -55 -57 -57 -57 -59 -55 -55 -57 -57 
-57 -55 -57 -57 -55 -55 -57 -57 -55 -57 
-57 -55 -57 -57 -55 -57 -55 -57 -57 -57 
-57 -57 -57 -57 -57 -57 -57 -59 -57 -57 
-57 -57 -57 -57 -57 -55 -57 -57 -57 -57 
-57 -57 -55 -55 -57 -57 -57 -57 -91 -57 
-57 -57 -55 -59 -57 -57 -57 -55 -55 -55 
-57 -57 -57 -91 -55 -57 -57 -57 -55 -91 
-55 -55 -57 -59 -57 -57 -55 -55 -57 -57 
-55 -57 -55 -57 -57 -57 -57 -57 -57 -57 
-57 -57 -57 -57 -55 -57 -57 -57 -57 -57 
-57 -57 -57 -57 -57 -57 -57 -57 -57 -57 
-57 -57 -57 -57 -55 -55 -57 -57 -57 -57 
-57 -57 -57 -57 -57 -57 -57 -55 -57 -57 
-57 -57 -57 -55 -57 -57 -57 -57 -55 -57 
-57 -57 -55 -57 -57 -57 -57 -57 -57 -57 
-57 -89 -55 -57 -57 -57 -57 -55 -55 -57 
-57 -57 -57 -57 -57 -57 -57 -57 -57 -57 
-57 -57 -57 -57 -57 -57 -55 -57 -57 -55 
-57 -57 -57 -57 -57 -57 -55 -57 -55 -55 
-81 -57 -57 -57 -57 -57 -57 -57 -57 -57 
-57 -59 -57 -57 -57 -57 -55 -57 -57 -57 
-59 -57 -57 -57 -57 -57 -55 -57 -57 -57 
-57 -57 -57 -57 -55 -57 -59 -57 -55 -57 
-57 -57 -59 -57 -57 -57 -57 -57 -89 -57 
-57 -57 -57 -55 -57 -57 -57 -57 -55 -57 
-55 -57 -55 -57 -57 -57 -57 -57 -57 -57 
-55 -55 -57 -55 -57 -55 -57 -57 -57 -57 
-57 -57 -55 -57 -57 -57 -55 -57 -57 -57 
-57 -57 -57 -57 -57 -57 -55 -57 -57 -55 
-57 -55 -57 -55 -59 -57 -57 -57 -57 -55 
-57 -57 -57 -57 -57 -57 -55 -55 -55 -57 
-57 -57 -55 -55 -57 -55 -57 -59 -57 -57 
-57 -57 -57 -57 -57 -57 -91 -57 -57 -57 
-57 -57 -57 -55 -57 -57 -57 -57 -57 -57 
-57 -55 -57 -57 -57 -57 -57 -55 -57 -55 
-57 -57 -57 -55 -57 -55 -55 -57 -57 -57 
-59 -57 -57 -57 -57 -57 -57 -55 -55 -57 
-55 -57 -55 -55 -55 -57 -55 -57 -55 -57 
-57 -57 -57 -57 -57 -57 -57 -57 -57 -57 
-57 -55 -55 -57 -57 -57 -57 -57 -57 -57 
-55 -57 -57 -57 -55 -57 -55 -57 -55 -57 
-57 -57 -57 -55 -57 -57 -59 -57 -57 -57 
-57 -55 -57 -57 -57 -57 -57 -57 -57 -57 
-57 -55 -57 -55 -57 -57 -57 -55 -57 -55 
-57 -57 -55 -57 -57 -57 -55 -57 -55 -55 
-57 -57 -55 -57 -57 -57 -57 -57 -57 -57 
-55 -57 -57 -57 -57 -91 -57 -57 -57 -57 
-55 -57 -55 -57 -57 -55 -57 -55 -57 -57 
-55 -57 -57 -55 -57 -55 -57 -55 -57 -57 
-55 -57 -57 -57 -55 -57 -57 -55 -55 -57 
-57 -57 -57 -57 -57 -55 -55 -57 -57 -57 
-57 -57 -57 -57 -57 -55 -57 -59 -61 -57 
-57 -57 -57 -57 -57 -57 -55 -57 -55 -55 
-57 -57 -55 -55 -57 -57 -57 -57 -57 -57 
-57 -55 -57 -57 -57 -57 -57 -57 -57 -57 
-57 -57 -55 -57 -57 -57 -55 -57 -57 -57 
-55 -57 -57 -57 -57 -59 -57 -55 -57 -57 
-57 -57 -57 -57 -57 -55 -57 -57 -57 -55 
-57 -57 -55 -57 -57 -55 -57 -57 -57 -57 
-57 -57 -55 -57 -57 -57 -57 -57 -57 -57 
-57 -57 -55 -57 -57 -57 -55 -57 -57 -57 
-57 -55 -55 -57 -55 -55 -55 -55 -57 -57 
-57 -57 -57 -57 -57 -57 -57 -57 -57 -57 
-57 -55 -57 -57 -57 -57 -57 -55 -57 -57 
-57 -57 -57 -55 -55 -57 -57 -57 -57 -57 
-55 -57 -57 -57 -55 -57 -57 -57 -57 -57 
-55 -57 -55 -57 -57 -57 -55 -55 -57 -55 
-55 -57 -55 -57 -57 -55 -57 -55 -55 -57 
-55 -57 -55 -57 -57 -57 -55 -57 -57 -57 
-55 -57 -55 -59 -57 -57 -57 -55 -57 -57 
-57 -55 -57 -57 -57 -55 -57 -57 -57 -55 
-57 -55 -55 -59 -57 -57 -55 -57 -57 -59 
-57 -57 -61 -61 -57 -57 -57 -57 -57 -57 
-57 -55 -57 -55 -57 -57 -57 -55 -57 -57 
-57 -57 -57 -57 -55 -57 -55 -57 -57 -57 
-57 -57 -57 -57 -55 -57 -57 -57 -57 -57 
-57 -57 -57 -57 -55 -57 -55 -57 -55 -57 
-55 -55 -57 -57 -57 -57 -57 -57 -55 -57 
-59 -57 -57 -57 -55 -57 -57 -55 -57 -57 
-57 -91 -57 -57 -57 -55 -57 -57 -57 -57 
-57 -57 -57 -57 -55 -57 -57 -57 -59 -57 
-57 -55 -57 -57 -57 -57 -57 -57 -55 -57 
-57 -57 -57 -57 -57 -57 -57 -57 -59 -57 
-57 -57 -57 -57 -55 -57 -57 -57 -55 -59 
-57 -55 -57 -55 -57 -57 -57 -57 -57 -57 
-57 -57 -57 -57 -57 -57 -57 -55 -57 -55 
-57 -57 -57 -55 -57 -55 -55 -57 -55 -57 
-55 -57 -57 -57 -57 -57 -57 -57 -59 -57 
-57 -55 -57 -57 -57 -57 -57 -57 -57 -57 
-57 -55 -55 -57 -55 -57 -55 -57 -55 -57 
-57 -57 -57 -55 -57 -57 -55 -57 -55 -57 
-57 -55 -55 -57 -57 -55 -57 -57 -57 -57 
-55 -57 -57 -57 -55 -55 -55 -57 -57 -57 
-55 -55 -55 -57 -55 -55 -57 -57 -57 -55 
-57 -57 -57 -59 -57 -55 -57 -57 -57 -57 
-57 -55 -57 -55 -57 -55 -57 -57 -57 -59 
-55 -57 -55 -57 -57 -57 -57 -55 -57 -57 
-55 -57 -55 -55 -57 -57 -55 -57 -57 -57 
-57 -57 -57 -57 -57 -57 -57 -57 -55 -57 
-57 -57 -55 -57 -55 -57 -57 -57 -57 -57 
-57 -57 -57 -57 -55 -55 -57 -55 -57 -57 
-55 -55 -57 -55 -55 -55 -55 -87 -57 -57 
-57 -57 -57 -57 -57 -57 -57 -57 -57 -55 
-55 -57 -55 -55 -57 -55 -57 -55 -57 -55 
-57 -55 -57 -55 -55 -57 -57 -55 -57 -57 
-57 -57 -55 -57 -57 -57 -57 -57 -55 -57 
-57 -57 -57 -57 -55 -57 -57 -89 -57 -57 
-55 -57 -55 -57 -57 -57 -55 -57 -57 -57 
-57 -55 -55 -57 -57 -57 -57 -57 -57 -57 
-55 -57 -55 -57 -55 -57 -57 -57 -59 -57 
-55 -57 -55 -57 -57 -57 -57 -59 -57 -57 
-57 -57 -55 -57 -57 -57 -57 -57 -57 -55 
-57 -57 -57 -55 -57 -57 -55 -57 -57 -55 
-57 -55 -57 -57 -57 -57 -59 -57 -55 -57 
-57 -57 -57 -57 -55 -57 -57 -57 -57 -57 
-57 -57 -55 -57 -55 -57 -57 -57 -57 -57 
-57 -55 -55 -55 -57 -57 -55 -57 -57 -57 
-57 -55 -57 -57 -55 -57 -57 -57 -57 -57 
-57 -57 -57 -57 -55 -55 -57 -57 -57 -57 
-57 -55 -55 -57 -57 -57 -55 -57 -57 -57 
-55 -57 -57 -57 -55 -57 -57 -55 -57 -57 
-57 -57 -57 -57 -57 -57 -57 -57 -57 -57 
-57 -57 -57 -57 -55 -57 -55 -57 -55 -57 
-57 -57 -57 -57 -55 -57 -57 -57 -57 -57 
-57 -57 -57 -57 -57 -55 -57 -57 -57 -57 
-57 -57 -57 -55 -57 -55 -57 -55 -57 -55 
-57 -55 -57 -57 -55 -55 -57 -57 -55 -57 
-55 -55 -57 -57 -55 -57 -55 -57 -55 -57 
-57 -55 -57 -55 -57 -55 -57 -57 -57 -57 
-57 -57 -57 -55 -55 -55 -57 -57 -57 -57 
-55 -57 -55 -57 -57 -55 -59 -57 -55 -57 
-57 -55 -57 -57 -55 -57 -55 -57 -57 -55 
-57 -57 -55 -57 -55 -57 -55 -55 -57 -57 
-57 -57 -57 -57 -57 -55 -55 -57 -57 -57 
