-51 -53 -53 -53 -53 -53 -53 -53 -53 -53 
-53 -53 -53 -53 -53 -53 -53 -53 -53 -53 
-53 -55 -53 -53 -55 -53 -53 -53 -53 -55 
-53 -53 -53 -51 -53 -53 -53 -55 -53 -53 
-55 -53 -55 -53 -51 -53 -53 -53 -51 -53 
-51 -55 -53 -53 -53 -55 -51 -51 -53 -55 
-53 -55 -57 -51 -53 -53 -55 -53 -55 -55 
-57 -51 -53 -53 -55 -53 -55 -51 -51 -53 
-53 -53 -53 -53 -55 -53 -53 -55 -51 -49 
-55 -53 -55 -55 -55 -57 -53 -53 -53 -57 
-55 -57 -53 -55 -53 -53 -53 -53 -53 -57 
-53 -55 -53 -53 -55 -53 -53 -53 -55 -53 
-57 -53 -55 -53 -57 -53 -55 -53 -53 -49 
-49 -53 -55 -53 -55 -55 -55 -55 -55 -57 
-55 -55 -53 -53 -53 -55 -53 -55 -53 -55 
-55 -55 -53 -53 -55 -55 -87 -53 -53 -55 
-55 -53 -55 -55 -55 -55 -53 -55 -53 -55 
-53 -55 -53 -53 -55 -53 -55 -55 -89 -55 
-53 -53 -55 -53 -55 -91 -55 -55 -55 -53 
-43 -55 -55 -53 -53 -55 -55 -53 -55 -55 
-55 -53 -55 -53 -55 -55 -55 -55 -57 -53 
-55 -53 -53 -55 -55 -53 -55 -53 -57 -53 
-55 -53 -53 -55 -53 -55 -53 -55 -53 -53 
-53 -55 -55 -57 -55 -55 -55 -55 -53 -55 
-53 -55 -53 -55 -55 -55 -55 -53 -53 -53 
-55 -53 -89 -55 -53 -53 -55 -53 -57 -55 
-55 -53 -55 -53 -55 -53 -55 -55 -57 -55 
-55 -53 -55 -55 -53 -55 -53 -55 -55 -55 
-55 -55 -53 -55 -53 -57 -55 -55 -53 -53 
-53 -57 -53 -55 -55 -55 -55 -55 -53 -55 
-53 -55 -55 -53 -55 -53 -55 -55 -55 -55 
-55 -55 -53 -55 -53 -57 -53 -55 -53 -55 
-53 -55 -55 -55 -55 -55 -53 -55 -55 -55 
-53 -55 -53 -55 -55 -55 -55 -55 -53 -55 
-53 -53 -53 -55 -53 -53 -55 -55 -53 -55 
-53 -57 -55 -55 -55 -57 -55 -55 -53 -55 
-53 -57 -55 -57 -55 -55 -55 -53 -57 -55 
-55 -51 -49 -51 -49 -55 -53 -55 -53 -55 
-53 -53 -53 -55 -53 -55 -55 -55 -53 -53 
-53 -53 -55 -55 -53 -55 -55 -53 -55 -53 
-53 -53 -55 -53 -55 -53 -55 -53 -57 -53 
-55 -55 -55 -55 -55 -53 -55 -53 -55 -55 
-55 -55 -53 -55 -53 -55 -53 -53 -53 -55 
-53 -55 -53 -55 -53 -53 -55 -53 -55 -53 
-55 -53 -55 -53 -53 -57 -53 -55 -53 -55 
-85 -53 -55 -53 -53 -55 -57 -55 -53 -55 
-91 -53 -55 -55 -55 -55 -55 -53 -55 -55 
-55 -55 -55 -53 -57 -55 -55 -53 -55 -53 
-53 -55 -55 -57 -53 -53 -55 -55 -57 -55 
-53 -53 -57 -53 -57 -53 -57 -53 -55 -53 
-55 -53 -55 -53 -53 -57 -55 -55 -53 -55 
-53 -55 -53 -55 -53 -55 -55 -55 -53 -53 
-55 -53 -55 -53 -55 -53 -55 -53 -55 -53 
-55 -53 -55 -55 -55 -55 -53 -53 -55 -55 
-55 -53 -55 -55 -53 -57 -55 -55 -55 -55 
-53 -57 -53 -55 -55 -53 -53 -55 -53 -53 
-53 -53 -53 -53 -51 -55 -53 -53 -53 -71 
-55 -57 -53 -57 -55 -57 -55 -55 -53 -55 
-55 -55 -55 -53 -53 -55 -53 -53 -53 -55 
-53 -55 -55 -55 -55 -55 -55 -55 -53 -57 
-53 -55 -53 -55 -53 -55 -53 -55 -89 -55 
-53 -53 -53 -53 -53 -55 -53 -53 -53 -55 
-53 -55 -53 -55 -53 -53 -53 -55 -53 -55 
-53 -55 -53 -55 -55 -53 -55 -55 -55 -55 
-53 -53 -55 -55 -55 -53 -55 -53 -53 -55 
-55 -55 -55 -55 -55 -55 -53 -55 -53 -55 
-53 -57 -53 -55 -55 -53 -55 -53 -53 -55 
-53 -55 -53 -55 -53 -55 -53 -55 -53 -55 
-53 -53 -55 -53 -55 -53 -55 -53 -55 -55 
-55 -55 -53 -55 -53 -55 -53 -53 -53 -53 
-53 -55 -53 -55 -53 -53 -53 -55 -53 -55 
-53 -55 -55 -53 -55 -53 -55 -89 -53 -55 
-53 -55 -55 -55 -53 -53 -53 -55 -55 -53 
-53 -55 -55 -57 -53 -85 -55 -57 -55 -55 
-53 -55 -57 -55 -55 -55 -55 -53 -53 -55 
-53 -55 -55 -55 -53 -55 -53 -53 -55 -55 
-55 -55 -53 -53 -53 -55 -53 -55 -53 -53 
-53 -55 -49 -49 -49 -51 -51 -47 -49 -49 
-49 -47 -53 -49 -49 -51 -53 -51 -51 -51 
-51 -51 -51 -51 -53 -51 -51 -51 -51 -49 
-49 -49 -49 -51 -49 -51 -53 -51 -47 -45 
-47 -47 -47 -49 -49 -45 -51 -51 -47 -45 
-53 -55 -59 -59 -47 -47 -45 -49 -47 -49 
-51 -51 -49 -51 -53 -51 -51 -49 -47 -53 
-51 -49 -53 -51 -51 -51 -51 -51 -51 -51 
-51 -51 -53 -51 -51 -51 -51 -51 -49 -53 
-51 -51 -51 -49 -51 -53 -53 -49 -51 -53 
-49 -53 -51 -53 -51 -51 -53 -49 -51 -49 
-51 -49 -51 -51 -49 -51 -49 -51 -49 -51 
-49 -53 -49 -53 -49 -53 -51 -49 -53 -51 
-49 -53 -49 -51 -49 -91 -49 -49 -51 -51 
-49 -51 -49 -51 -41 -51 -49 -51 -49 -49 
-49 -51 -47 -51 -51 -47 -51 -51 -51 -49 
-51 -49 -83 -83 -53 -51 -53 -53 -53 -49 
-87 -53 -51 -51 -53 -51 -51 -51 -51 -53 
-51 -49 -47 -51 -51 -51 -49 -51 -49 -51 
-49 -49 -49 -51 -49 -51 -49 -51 -51 -51 
-49 -53 -49 -91 -53 -55 -53 -53 -53 -55 
-53 -55 -53 -55 -51 -53 -53 -53 -49 -49 
-51 -49 -51 -51 -51 -51 -53 -55 -53 -55 
-53 -53 -49 -51 -91 -53 -51 -55 -57 -53 
-53 -53 -55 -53 -55 -55 -57 -53 -55 -53 
-51 -53 -51 -53 -51 -55 -53 -55 -53 -53 
-55 -51 -51 -53 -51 -53 -53 -55 -53 -55 
-53 -55 -55 -53 -55 -55 -55 -55 -55 -55 
-55 -55 -53 -57 -55 -43 -53 -51 -53 -53 
-51 -51 -55 -55 -53 -51 -55 -53 -55 -53 
-53 -53 -51 -51 -51 -49 -51 -53 -53 -49 
-51 -49 -49 -47 -49 -47 -49 -47 -49 -49 
-47 -45 -47 -47 -49 -87 -51 -49 -51 -49 
-51 -51 -51 -47 -49 -51 -51 -49 -47 -49 
-47 -91 -47 -49 -47 -49 -49 -49 -47 -51 
-49 -51 -49 -53 -51 -51 -49 -53 -53 -51 
-49 -51 -49 -53 -49 -53 -51 -49 -51 -49 
-53 -51 -49 -49 -49 -49 -49 -47 -53 -49 
-53 -49 -51 -49 -53 -51 -51 -51 -51 -49 
-51 -51 -53 -51 -51 -51 -51 -49 -51 -53 
-53 -53 -51 -53 -53 -51 -53 -51 -51 -53 
-49 -49 -53 -49 -51 -49 -49 -47 -49 -49 
-51 -49 -51 -49 -51 -49 -51 -51 -53 -51 
-53 -51 -53 -53 -55 -53 -51 -51 -53 -53 
-53 -53 -53 -51 -53 -53 -53 -53 -55 -55 
-53 -55 -53 -55 -55 -55 -55 -55 -53 -53 
-53 -55 -53 -55 -53 -55 -55 -55 -53 -55 
-53 -53 -53 -53 -53 -55 -53 -53 -55 -55 
-55 -55 -91 -91 -55 -55 -53 -55 -53 -53 
-53 -57 -55 -55 -53 -55 -55 -55 -53 -55 
-55 -55 -53 -55 -53 -55 -55 -55 -55 -53 
-55 -55 -53 -55 -55 -53 -53 -53 -53 -53 
-53 -53 -53 -53 -53 -55 -53 -55 -53 -55 
-53 -53 -55 -53 -53 -53 -53 -53 -55 -53 
-53 -53 -53 -53 -55 -53 -53 -53 -55 -53 
-55 -53 -55 -53 -53 -57 -51 -49 -49 -51 
-51 -51 -51 -51 -49 -51 -51 -49 -51 -49 
-51 -49 -51 -51 -53 -55 -53 -55 -53 -53 
-53 -55 -53 -79 -53 -57 -53 -55 -53 -55 
-53 -55 -53 -55 -53 -55 -53 -55 -53 -55 
-53 -55 -53 -55 -53 -55 -53 -57 -53 -55 
-55 -55 -53 -55 -53 -55 -55 -55 -53 -57 
-53 -53 -53 -55 -53 -53 -53 -53 -53 -55 
-53 -43 -53 -55 -53 -55 -53 -55 -55 -55 
-53 -53 -53 -55 -53 -55 -53 -53 -53 -53 
-53 -53 -53 -55 -53 -53 -55 -53 -53 -53 
-55 -53 -55 -53 -55 -53 -53 -53 -55 -53 
-55 -53 -55 -53 -57 -53 -55 -53 -57 -55 
-53 -53 -53 -53 -53 -53 -53 -55 -53 -53 
-53 -53 -55 -53 -55 -53 -53 -55 -53 -53 
-55 -53 -53 -57 -53 -53 -53 -53 -55 -53 
-53 -53 -53 -53 -55 -53 -55 -53 -55 -53 
-57 -53 -55 -53 -53 -53 -53 -55 -57 -55 
-55 -53 -55 -53 -55 -53 -57 -53 -55 -53 
-53 -55 -55 -55 -55 -55 -55 -53 -53 -55 
-55 -55 -53 -55 -53 -53 -53 -55 -53 -55 
-53 -53 -55 -55 -53 -53 -55 -53 -55 -53 
-55 -53 -55 -45 -55 -53 -53 -53 -53 -55 
-53 -53 -55 -55 -53 -57 -53 -57 -55 -53 
-55 -53 -55 -55 -55 -53 -53 -55 -53 -55 
-49 -49 -53 -55 -55 -55 -51 -53 -55 -57 
-53 -53 -91 -53 -53 -53 -55 -53 -55 -53 
-53 -53 -53 -53 -55 -53 -55 -53 -55 -53 
-53 -53 -53 -53 -53 -53 -53 -53 -53 -53 
-55 -55 -53 -53 -53 -53 -55 -53 -55 -53 
-55 -53 -55 -53 -55 -53 -53 -53 -55 -55 
-53 -53 -53 -53 -55 -53 -55 -55 -55 -53 
-51 -53 -53 -53 -53 -53 -53 -55 -53 -53 
-53 -53 -53 -55 -53 -53 -53 -53 -55 -53 
-53 -55 -53 -55 -53 -53 -53 -53 -53 -53 
-53 -53 -55 -53 -55 -53 -53 -55 -55 -53 
-53 -53 -53 -91 -53 -55 -53 -55 -53 -53 
-53 -53 -53 -51 -53 -53 -53 -53 -55 -55 
-55 -55 -53 -53 -53 -51 -53 -55 -53 -55 
-55 -55 -53 -53 -53 -53 -55 -53 -55 -53 
-55 -53 -57 -53 -55 -53 -53 -53 -53 -55 
-53 -53 -53 -51 -53 -53 -53 -53 -53 -53 
-55 -53 -55 -53 -53 -53 -49 -53 -55 -55 
-51 -55 -55 -51 -51 -51 -53 -51 -51 -51 
-53 -53 -53 -51 -53 -53 -53 -51 -49 -53 
-55 -55 -57 -55 -55 -53 -51 -51 -53 -53 
-53 -51 -49 -51 -49 -51 -49 -49 -49 -49 
-49 -51 -47 -49 -49 -49 -47 -49 -47 -49 
-49 -49 -49 -51 -49 -53 -51 -51 -51 -53 
-51 -51 -55 -53 -53 -51 -49 -51 -49 -49 
-49 -51 -49 -49 -47 -49 -53 -51 -53 -51 
-53 -51 -55 -51 -53 -55 -53 -57 -51 -53 
-51 -53 -51 -49 -49 -49 -89 -49 -49 -57 
-57 -53 -53 -45 -53 -45 -47 -45 -47 -53 
-55 -57 -53 -53 -55 -55 -53 -55 -53 -57 
-53 -53 -53 -51 -55 -55 -59 -51 -53 -53 
-51 -55 -55 -55 -53 -51 -51 -51 -51 -53 
-53 -53 -55 -57 -53 -55 -55 -53 -55 -53 
-53 -49 -51 -53 -53 -51 -51 -49 -51 -53 
-51 -53 -51 -53 -51 -53 -53 -53 -55 -87 
-51 -53 -51 -53 -55 -49 -51 -51 -49 -51 
-53 -51 -51 -53 -53 -57 -55 -55 -91 -91 
-53 -55 -91 -53 -55 -51 -53 -53 -53 -53 
-53 -51 -49 -51 -51 -51 -53 -53 -57 -51 
-55 -53 -53 -53 -55 -53 -55 -53 -53 -57 
-51 -53 -53 -55 -55 -57 -51 -53 -53 -53 
-55 -57 -53 -55 -51 -51 -51 -51 -49 -53 
-53 -55 -51 -53 -53 -55 -49 -51 -49 -51 
-49 -51 -51 -49 -47 -47 -51 -53 -51 -53 
-45 -45 -51 -47 -49 -45 -47 -47 -47 -51 
-51 -55 -59 -55 -57 -55 -55 -53 -55 -55 
-55 -55 -53 -51 -53 -51 -43 -51 -53 -51 
-51 -53 -55 -57 -53 -51 -49 -53 -53 -53 
-53 -55 -53 -57 -51 -53 -51 -53 -55 -53 
-55 -55 -55 -51 -53 -53 -57 -53 -55 -51 
-53 -51 -53 -53 -55 -53 -53 -53 -53 -91 
-53 -57 -55 -55 -53 -53 -55 -55 -57 -55 
-57 -55 -59 -55 -53 -57 -55 -53 -53 -91 
-55 -53 -53 -55 -53 -53 -53 -55 -55 -53 
-55 -53 -55 -53 -53 -53 -55 -53 -53 -53 
-53 -53 -53 -55 -53 -53 -55 -53 -55 -53 
-53 -53 -53 -53 -53 -55 -53 -55 -53 -53 
-53 -53 -53 -55 -53 -53 -53 -53 -53 -55 
-53 -53 -53 -53 -53 -55 -53 -55 -53 -55 
-53 -53 -51 -53 -53 -51 -53 -53 -55 -53 
-55 -53 -55 -53 -53 -53 -53 -55 -55 -55 
-55 -53 -53 -55 -53 -55 -53 -53 -55 -55 
-53 -55 -53 -53 -53 -53 -53 -55 -55 -53 
-53 -53 -55 -53 -53 -53 -53 -53 -53 -53 
-55 -53 -55 -53 -55 -91 -53 -53 -55 -53 
-55 -55 -55 -55 -55 -53 -53 -55 -53 -55 
-53 -57 -53 -55 -53 -57 -53 -53 -53 -55 
-53 -55 -53 -53 -55 -55 -55 -55 -57 -55 
-55 -55 -55 -53 -55 -53 -55 -53 -55 -55 
-55 -53 -57 -53 -55 -53 -55 -53 -55 -53 
-55 -55 -55 -57 -57 -65 -53 -55 -53 -55 
-53 -53 -55 -53 -55 -53 -55 -53 -55 -55 
-55 -53 -55 -55 -53 -55 -53 -55 -53 -55 
-55 -53 -53 -55 -55 -55 -55 -53 -55 -55 
-53 -55 -55 -53 -53 -53 -55 -53 -55 -55 
-55 -53 -55 -53 -55 -53 -55 -75 -75 -53 
-51 -53 -55 -53 -55 -53 -53 -55 -53 -53 
-55 -53 -55 -53 -55 -55 -55 -53 -55 -53 
-57 -53 -55 -53 -55 -53 -55 -53 -55 -53 
-55 -53 -55 -53 -55 -55 -55 -53 -55 -53 
-53 -55 -43 -53 -55 -55 -53 -55 -53 -53 
-55 -53 -55 -55 -53 -53 -55 -53 -55 -53 
-53 -53 -55 -53 -55 -55 -55 -53 -55 -53 
-55 -53 -55 -53 -55 -53 -55 -55 -55 -55 
-53 -53 -53 -53 -55 -53 -53 -55 -55 -53 
-53 -53 -55 -53 -53 -55 -55 -53 -53 -55 
-53 -55 -53 -55 -53 -57 -55 -53 -55 -53 
-55 -53 -55 -53 -53 -53 -55 -53 -55 -53 
-55 -53 -55 -53 -53 -55 -55 -53 -53 -53 
-57 -53 -55 -55 -55 -55 -55 -55 -53 -53 
-43 -55 -53 -53 -53 -55 -53 -53 -53 -53 
-55 -55 -55 -55 -55 -55 -53 -55 -53 -55 
-53 -53 -43 -55 -53 -55 -53 -55 -55 -55 
-53 -55 -53 -55 -53 -55 -55 -53 -55 -53 
-55 -53 -53 -53 -55 -51 -53 -53 -55 -55 
-55 -55 -55 -53 -55 -55 -55 -55 -53 -53 
-55 -55 -55 -55 -53 -53 -55 -55 -55 -53 
-55 -53 -53 -55 -53 -55 -55 -55 -53 -53 
-53 -55 -53 -53 -55 -55 -53 -53 -55 -53 
-55 -53 -53 -55 -53 -55 -53 -55 -53 -55 
-53 -53 -53 -53 -53 -55 -53 -57 -53 -55 
-53 -55 -53 -53 -53 -55 -53 -55 -55 -55 
-53 -55 -53 -55 -53 -55 -53 -53 -53 -53 
-55 -53 -91 -53 -55 -53 -55 -51 -49 -53 
-53 -53 -55 -53 -53 -53 -53 -53 -53 -55 
-55 -55 -53 -53 -55 -53 -53 -55 -91 -91 
-53 -55 -55 -55 -53 -53 -53 -53 -53 -55 
-53 -53 -53 -53 -55 -55 -53 -53 -53 -55 
-53 -53 -53 -53 -53 -55 -53 -55 -53 -53 
-53 -53 -53 -53 -55 -53 -53 -55 -53 -55 
-53 -55 -53 -55 -53 -53 -53 -53 -53 -53 
-53 -53 -53 -45 -53 -53 -55 -53 -53 -53 
-55 -53 -53 -53 -55 -53 -55 -53 -55 -53 
-55 -53 -53 -91 -53 -55 -53 -53 -53 -53 
-53 -53 -53 -53 -55 -53 -53 -53 -55 -53 
-53 -53 -55 -53 -53 -55 -55 -53 -55 -53 
-53 -53 -55 -53 -55 -53 -55 -53 -55 -53 
-53 -53 -55 -53 -51 -49 -55 -55 -53 -55 
-53 -55 -53 -53 -55 -55 -53 -55 -53 -53 
-55 -53 -53 -55 -53 -55 -53 -53 -53 -55 
-53 -55 -53 -55 -53 -55 -53 -55 -55 -55 
-53 -55 -53 -55 -55 -55 -53 -55 -53 -55 
-53 -53 -53 -55 -55 -55 -53 -53 -53 -53 
-53 -55 -53 -55 -55 -53 -53 -55 -53 -55 
-55 -55 -55 -53 -55 -53 -53 -53 -55 -53 
-55 -53 -53 -53 -57 -55 -55 -55 -55 -53 
-55 -53 -53 -53 -53 -53 -53 -53 -53 -53 
-53 -53 -53 -53 -53 -55 -53 -53 -53 -53 
-53 -55 -55 -53 -53 -53 -55 -53 -55 -53 
-55 -55 -53 -53 -53 -55 -53 -53 -53 -79 
-53 -55 -53 -55 -53 -53 -51 -55 -57 -57 
-55 -55 -53 -53 -51 -53 -51 -55 -59 -53 
-55 -49 -49 -49 -51 -51 -53 -51 -51 -53 
-55 -49 -91 -53 -51 -53 -55 -53 -55 -53 
-55 -51 -53 -49 -51 -47 -49 -53 -53 -49 
-53 -51 -87 -51 -53 -53 -55 -53 -53 -55 
-53 -53 -51 -53 -53 -51 -53 -51 -55 -53 
-55 -53 -57 -53 -57 -53 -57 -55 -55 -55 
-55 -55 -57 -55 -55 -55 -55 -55 -57 -57 
-53 -57 -55 -57 -53 -57 -53 -55 -53 -91 
-53 -55 -53 -55 -55 -55 -55 -55 -55 -55 
-51 -53 -51 -51 -51 -53 -51 -53 -53 -91 
-51 -53 -53 -55 -53 -57 -53 -57 -53 -53 
