-61 -61 -61 -61 -61 -59 -59 -59 -59 -59 
-57 -59 -61 -61 -59 -59 -59 -59 -57 -59 
-59 -59 -57 -59 -91 -59 -55 -59 -57 -59 
-59 -57 -57 -57 -57 -57 -55 -57 -57 -59 
-57 -59 -57 -59 -59 -61 -57 -61 -61 -61 
-57 -67 -65 -65 -65 -65 -61 -61 -57 -65 
-61 -59 -57 -59 -57 -61 -61 -63 -61 -59 
-59 -59 -57 -57 -59 -59 -59 -57 -63 -61 
-61 -61 -63 -61 -61 -61 -67 -67 -61 -61 
-59 -59 -57 -57 -59 -57 -59 -57 -69 -61 
-59 -57 -57 -57 -59 -59 -59 -59 -61 -57 
-59 -59 -59 -59 -59 -63 -59 -61 -65 -61 
-59 -63 -63 -61 -63 -63 -61 -57 -61 -59 
-59 -55 -61 -61 -61 -59 -63 -61 -61 -59 
-89 -61 -61 -59 -59 -57 -57 -57 -59 -57 
-59 -59 -61 -59 -61 -61 -63 -59 -61 -59 
-59 -61 -59 -61 -61 -63 -61 -63 -61 -61 
-63 -61 -63 -63 -63 -63 -63 -65 -63 -61 
-65 -65 -63 -63 -63 -61 -57 -61 -61 -61 
-59 -59 -59 -59 -57 -57 -57 -57 -53 -57 
-55 -57 -55 -57 -55 -59 -57 -61 -61 -61 
-59 -63 -61 -59 -57 -57 -55 -57 -55 -57 
-55 -57 -53 -55 -55 -57 -59 -57 -55 -55 
-53 -53 -53 -55 -51 -55 -53 -55 -53 -57 
-55 -57 -55 -55 -55 -55 -53 -55 -57 -57 
-53 -59 -55 -57 -57 -57 -59 -57 -55 -55 
-55 -55 -55 -53 -59 -57 -55 -53 -57 -61 
-57 -61 -59 -63 -59 -61 -61 -59 -63 -61 
-65 -65 -61 -59 -61 -59 -61 -61 -61 -59 
-61 -59 -61 -63 -63 -63 -63 -63 -63 -61 
-63 -63 -61 -61 -65 -63 -63 -63 -63 -59 
-61 -57 -61 -57 -61 -59 -59 -57 -57 -57 
-61 -59 -61 -61 -61 -61 -61 -61 -59 -59 
-59 -57 -55 -55 -61 -57 -61 -59 -59 -59 
-57 -57 -59 -55 -57 -53 -57 -55 -57 -55 
-55 -53 -57 -91 -55 -57 -57 -63 -65 -59 
-57 -59 -55 -57 -91 -59 -55 -57 -57 -57 
-57 -55 -57 -55 -59 -59 -61 -57 -63 -59 
-65 -65 -61 -59 -61 -59 -59 -59 -63 -61 
-65 -63 -63 -63 -61 -61 -59 -59 -59 -59 
-57 -59 -57 -57 -59 -57 -61 -59 -59 -57 
-59 -63 -61 -59 -59 -61 -59 -59 -59 -57 
-61 -59 -59 -57 -59 -57 -59 -57 -59 -57 
-57 -57 -57 -57 -59 -59 -61 -59 -61 -61 
-63 -59 -85 -67 -65 -59 -59 -61 -61 -59 
-57 -57 -59 -59 -57 -59 -59 -61 -59 -61 
-61 -59 -57 -57 -55 -59 -57 -59 -57 -57 
-57 -59 -57 -61 -61 -61 -59 -61 -57 -57 
-57 -57 -55 -59 -57 -55 -57 -59 -55 -57 
-55 -59 -57 -57 -57 -57 -55 -59 -57 -57 
-55 -57 -55 -59 -55 -59 -57 -57 -57 -57 
-55 -59 -57 -59 -57 -59 -57 -59 -57 -61 
-91 -59 -57 -59 -57 -59 -59 -59 -57 -57 
-55 -59 -59 -59 -57 -59 -57 -53 -57 -59 
-57 -57 -55 -57 -57 -57 -53 -57 -57 -55 
-57 -59 -57 -55 -57 -57 -59 -57 -59 -59 
-59 -59 -59 -57 -57 -57 -59 -55 -57 -57 
-59 -55 -57 -57 -57 -59 -57 -59 -59 -55 
-57 -57 -57 -57 -57 -57 -57 -57 -57 -57 
-55 -59 -57 -59 -57 -59 -55 -57 -57 -59 
-55 -57 -55 -57 -57 -59 -55 -57 -55 -57 
-55 -57 -55 -57 -59 -57 -57 -55 -57 -57 
-59 -57 -57 -55 -57 -55 -57 -57 -57 -57 
-57 -57 -57 -57 -55 -59 -57 -59 -57 -57 
-55 -57 -57 -59 -57 -59 -55 -59 -55 -57 
-55 -57 -55 -59 -57 -55 -59 -57 -59 -57 
-59 -55 -57 -57 -59 -57 -57 -57 -57 -55 
-57 -57 -51 -55 -59 -59 -57 -57 -55 -57 
-57 -57 -53 -57 -55 -57 -55 -59 -57 -59 
-57 -57 -57 -59 -55 -57 -59 -55 -57 -57 
-55 -57 -57 -57 -55 -59 -57 -59 -55 -57 
-57 -57 -57 -57 -55 -57 -55 -57 -57 -59 
-57 -59 -55 -57 -57 -59 -57 -59 -55 -59 
-57 -57 -57 -59 -55 -57 -57 -57 -55 -59 
-55 -59 -57 -57 -57 -57 -55 -59 -55 -57 
-55 -55 -55 -57 -57 -57 -55 -57 -57 -59 
-55 -59 -55 -91 -57 -57 -55 -57 -55 -59 
-55 -59 -55 -59 -55 -57 -55 -59 -55 -59 
-55 -59 -57 -57 -55 -57 -57 -59 -57 -57 
-57 -57 -57 -57 -57 -57 -55 -51 -57 -55 
-57 -55 -57 -55 -53 -55 -57 -57 -57 -55 
-57 -57 -59 -55 -57 -57 -59 -55 -59 -57 
-57 -55 -59 -55 -57 -57 -57 -55 -57 -57 
-57 -55 -57 -55 -57 -55 -57 -59 -57 -55 
-57 -57 -57 -55 -59 -57 -57 -57 -57 -59 
-55 -59 -57 -59 -55 -57 -57 -57 -57 -57 
-63 -59 -57 -57 -57 -57 -57 -75 -57 -57 
-55 -57 -55 -57 -55 -57 -57 -59 -55 -59 
-57 -59 -55 -57 -55 -57 -55 -59 -57 -61 
-59 -61 -59 -61 -59 -57 -57 -61 -61 -63 
-61 -59 -57 -69 -67 -61 -57 -57 -57 -57 
-59 -59 -61 -57 -59 -57 -59 -57 -61 -59 
-63 -61 -61 -61 -59 -59 -61 -59 -61 -59 
-59 -55 -59 -57 -59 -57 -63 -61 -59 -59 
-61 -59 -57 -61 -57 -61 -59 -61 -59 -61 
-59 -63 -61 -63 -59 -63 -63 -63 -61 -91 
-63 -63 -59 -61 -63 -61 -63 -63 -59 -61 
-63 -61 -59 -61 -59 -61 -59 -61 -59 -63 
-61 -61 -59 -61 -59 -61 -61 -61 -61 -59 
-61 -61 -61 -61 -63 -61 -61 -61 -61 -59 
-61 -57 -59 -57 -59 -59 -59 -59 -57 -61 
-61 -59 -59 -61 -59 -59 -59 -59 -57 -57 
-59 -55 -59 -59 -57 -59 -59 -59 -57 -57 
-55 -57 -57 -57 -57 -59 -57 -59 -55 -59 
-55 -69 -59 -55 -57 -55 -55 -55 -55 -55 
-59 -55 -57 -57 -59 -61 -55 -53 -61 -61 
-63 -67 -65 -63 -61 -59 -59 -59 -57 -57 
-59 -59 -59 -61 -59 -57 -59 -59 -57 -61 
-57 -57 -55 -59 -59 -59 -57 -57 -57 -61 
-61 -59 -59 -59 -55 -61 -59 -59 -57 -61 
-61 -63 -61 -63 -63 -59 -57 -57 -57 -59 
-57 -61 -57 -61 -59 -59 -57 -61 -61 -63 
-61 -61 -61 -59 -63 -61 -59 -61 -63 -61 
-61 -59 -61 -57 -59 -57 -61 -59 -55 -59 
-61 -59 -63 -63 -63 -61 -61 -57 -59 -59 
-59 -57 -61 -59 -61 -59 -61 -59 -61 -59 
-61 -59 -61 -59 -61 -57 -61 -59 -59 -59 
-61 -59 -59 -59 -59 -61 -61 -61 -59 -59 
-59 -61 -59 -61 -59 -61 -59 -61 -61 -59 
-59 -59 -57 -59 -57 -59 -55 -59 -59 -59 
-59 -59 -61 -57 -61 -61 -63 -59 -65 -63 
-65 -63 -61 -61 -61 -59 -59 -59 -57 -59 
-59 -61 -57 -59 -59 -57 -59 -57 -59 -57 
-59 -57 -59 -57 -57 -59 -57 -61 -63 -63 
-59 -59 -59 -61 -59 -61 -61 -59 -57 -61 
-59 -63 -61 -65 -67 -61 -59 -55 -59 -57 
-59 -57 -63 -59 -61 -59 -61 -59 -61 -57 
-63 -61 -63 -59 -63 -63 -63 -63 -61 -59 
-59 -59 -61 -63 -59 -61 -59 -61 -63 -63 
-61 -61 -63 -61 -59 -61 -57 -59 -59 -59 
-59 -59 -59 -59 -61 -59 -91 -59 -57 -61 
-59 -57 -59 -59 -59 -59 -63 -89 -61 -59 
-59 -57 -57 -59 -61 -61 -59 -61 -59 -59 
-57 -59 -59 -61 -59 -59 -57 -61 -57 -61 
-59 -59 -59 -59 -59 -59 -57 -61 -59 -61 
-59 -63 -61 -59 -61 -59 -61 -59 -61 -59 
-61 -59 -59 -57 -61 -59 -59 -59 -59 -59 
-59 -59 -59 -59 -59 -61 -59 -59 -57 -59 
-57 -61 -61 -59 -61 -59 -61 -61 -55 -57 
-61 -59 -59 -59 -61 -59 -59 -57 -87 -59 
-59 -59 -59 -59 -59 -57 -59 -59 -59 -59 
-59 -59 -61 -59 -61 -59 -61 -61 -59 -59 
-61 -59 -61 -59 -61 -59 -59 -59 -61 -61 
-59 -59 -59 -59 -59 -61 -59 -61 -59 -61 
-61 -61 -61 -61 -59 -61 -59 -59 -57 -61 
-57 -61 -61 -59 -61 -59 -61 -59 -59 -61 
-57 -61 -59 -59 -61 -59 -59 -59 -57 -59 
-59 -59 -61 -61 -61 -61 -61 -63 -63 -63 
-63 -59 -59 -59 -57 -59 -57 -57 -59 -57 
-57 -59 -57 -61 -59 -63 -63 -59 -59 -59 
-57 -61 -59 -61 -61 -59 -59 -61 -59 -61 
-61 -61 -59 -59 -59 -57 -55 -57 -57 -61 
-57 -59 -59 -61 -57 -61 -59 -59 -59 -63 
-61 -63 -63 -61 -61 -59 -61 -59 -61 -57 
-61 -59 -61 -85 -59 -61 -59 -59 -59 -61 
-59 -59 -61 -59 -59 -61 -61 -59 -57 -59 
-57 -57 -59 -57 -61 -61 -57 -59 -59 -57 
-67 -65 -63 -67 -59 -57 -57 -55 -61 -59 
-61 -51 -61 -57 -57 -59 -57 -61 -59 -65 
-63 -65 -63 -61 -63 -61 -61 -63 -61 -61 
-61 -63 -63 -61 -61 -61 -59 -59 -57 -57 
-57 -59 -57 -57 -57 -59 -57 -57 -57 -59 
-57 -57 -57 -59 -57 -61 -57 -61 -59 -59 
-59 -59 -57 -61 -59 -59 -59 -59 -57 -57 
-59 -59 -59 -59 -59 -57 -59 -59 -59 -57 
-61 -59 -59 -59 -59 -59 -59 -59 -61 -59 
-61 -59 -59 -59 -61 -59 -61 -59 -61 -59 
-61 -57 -59 -53 -59 -59 -59 -61 -59 -61 
-59 -59 -57 -61 -59 -59 -57 -59 -59 -61 
-57 -61 -59 -61 -59 -61 -57 -59 -57 -61 
-59 -61 -59 -59 -59 -59 -61 -61 -61 -61 
-59 -61 -59 -61 -59 -59 -59 -61 -59 -59 
-59 -59 -57 -59 -59 -91 -59 -57 -59 -57 
-59 -59 -59 -57 -59 -59 -59 -59 -59 -57 
-61 -61 -61 -59 -59 -61 -57 -61 -63 -61 
-59 -57 -59 -59 -57 -57 -59 -55 -59 -59 
-57 -59 -59 -57 -59 -59 -59 -59 -59 -57 
-59 -59 -59 -57 -59 -59 -57 -59 -59 -59 
-59 -57 -61 -57 -59 -59 -57 -59 -59 -59 
-59 -59 -57 -59 -57 -59 -59 -61 -61 -55 
-59 -59 -59 -61 -57 -59 -59 -59 -59 -61 
-61 -59 -57 -57 -55 -55 -55 -55 -55 -57 
-55 -75 -75 -57 -57 -57 -55 -59 -55 -59 
-59 -61 -59 -61 -59 -65 -67 -61 -61 -61 
-61 -61 -59 -61 -55 -61 -59 -57 -57 -59 
-57 -59 -55 -59 -55 -57 -57 -57 -59 -57 
-59 -57 -57 -55 -59 -57 -59 -57 -61 -59 
-61 -61 -59 -57 -59 -57 -59 -55 -59 -57 
-59 -57 -61 -61 -59 -57 -57 -55 -57 -53 
-57 -57 -91 -59 -57 -55 -57 -57 -57 -55 
-59 -57 -59 -59 -61 -59 -61 -57 -61 -59 
-61 -59 -61 -61 -61 -59 -61 -59 -61 -59 
-61 -61 -59 -55 -57 -55 -57 -55 -57 -55 
-57 -53 -57 -55 -59 -55 -59 -59 -57 -57 
-57 -57 -55 -55 -55 -55 -53 -57 -55 -57 
-55 -59 -57 -61 -59 -61 -59 -61 -59 -59 
-57 -59 -59 -59 -57 -65 -61 -59 -55 -65 
-65 -59 -59 -61 -59 -61 -61 -61 -61 -61 
-61 -63 -61 -59 -59 -61 -53 -65 -91 -61 
-61 -61 -59 -61 -59 -59 -57 -61 -59 -59 
-59 -61 -57 -61 -61 -63 -61 -61 -59 -59 
-59 -59 -59 -59 -57 -63 -59 -63 -61 -63 
-61 -63 -59 -63 -59 -61 -59 -63 -61 -61 
-59 -59 -57 -59 -57 -61 -59 -61 -57 -61 
-59 -59 -59 -85 -59 -59 -61 -57 -59 -57 
-59 -57 -59 -57 -59 -59 -59 -59 -61 -59 
-57 -59 -57 -59 -59 -63 -59 -61 -61 -61 
-61 -63 -63 -61 -59 -63 -61 -61 -59 -61 
-61 -61 -61 -61 -61 -59 -63 -59 -59 -57 
-59 -61 -59 -57 -61 -61 -59 -61 -59 -61 
-63 -65 -61 -61 -59 -59 -61 -57 -57 -55 
-59 -57 -59 -57 -61 -61 -61 -61 -61 -57 
-61 -59 -61 -59 -61 -59 -61 -61 -63 -59 
-61 -59 -61 -59 -61 -57 -55 -55 -55 -57 
-57 -59 -59 -59 -59 -57 -57 -55 -59 -59 
-59 -59 -59 -57 -57 -57 -55 -59 -55 -59 
-59 -59 -57 -59 -57 -59 -57 -57 -57 -55 
-55 -57 -55 -55 -55 -55 -57 -57 -57 -57 
-57 -57 -57 -55 -57 -55 -57 -55 -55 -55 
-55 -57 -59 -59 -61 -61 -91 -57 -57 -55 
-57 -57 -55 -55 -57 -55 -57 -55 -59 -59 
-59 -57 -57 -57 -57 -57 -57 -55 -57 -57 
-59 -57 -59 -61 -61 -61 -59 -59 -59 -59 
-59 -61 -59 -59 -59 -61 -59 -61 -57 -61 
-59 -61 -61 -61 -61 -61 -61 -59 -59 -59 
-57 -59 -57 -59 -57 -61 -57 -61 -59 -61 
-59 -61 -63 -59 -61 -59 -63 -59 -61 -61 
-61 -61 -61 -59 -53 -61 -61 -57 -61 -59 
-63 -61 -61 -61 -61 -59 -61 -59 -61 -61 
-61 -61 -61 -61 -61 -61 -59 -61 -61 -57 
-61 -61 -61 -59 -61 -61 -61 -59 -61 -57 
-61 -61 -61 -61 -63 -61 -59 -61 -61 -61 
-61 -59 -61 -59 -61 -59 -61 -59 -61 -61 
-61 -61 -61 -59 -61 -57 -61 -59 -61 -61 
-61 -59 -61 -61 -59 -61 -59 -61 -61 -61 
-59 -61 -59 -61 -59 -61 -61 -61 -61 -59 
-59 -59 -59 -61 -59 -61 -59 -61 -59 -61 
-59 -61 -59 -61 -59 -61 -61 -61 -57 -61 
-59 -59 -61 -61 -61 -59 -61 -59 -61 -61 
-71 -61 -59 -59 -61 -61 -61 -61 -59 -61 
-59 -57 -59 -59 -61 -61 -59 -61 -59 -61 
-61 -59 -61 -61 -57 -61 -61 -69 -61 -59 
-61 -59 -61 -57 -61 -57 -61 -59 -61 -61 
-61 -59 -61 -57 -61 -59 -61 -59 -61 -57 
-61 -59 -61 -59 -61 -61 -61 -61 -59 -59 
-59 -61 -61 -59 -59 -61 -59 -61 -59 -61 
-59 -61 -61 -59 -59 -61 -59 -61 -59 -61 
-61 -61 -59 -61 -59 -61 -61 -59 -59 -59 
-57 -57 -57 -53 -57 -57 -61 -59 -55 -55 
-57 -55 -57 -55 -57 -55 -55 -55 -57 -57 
-57 -55 -57 -55 -57 -55 -57 -57 -61 -59 
-61 -59 -61 -61 -61 -63 -63 -61 -61 -61 
-63 -61 -59 -59 -61 -59 -57 -57 -59 -59 
-59 -61 -59 -59 -61 -59 -63 -61 -61 -61 
-61 -63 -61 -63 -61 -61 -61 -61 -63 -61 
-59 -59 -59 -61 -59 -57 -61 -57 -59 -57 
-61 -57 -55 -57 -55 -55 -57 -55 -55 -55 
-55 -55 -53 -55 -53 -55 -55 -55 -57 -57 
-91 -59 -57 -59 -59 -59 -57 -59 -59 -61 
-59 -61 -61 -61 -59 -59 -59 -59 -59 -59 
-57 -57 -57 -59 -57 -57 -59 -57 -55 -57 
-57 -57 -55 -57 -57 -57 -55 -55 -55 -57 
-57 -57 -53 -57 -55 -57 -53 -55 -51 -53 
-55 -53 -55 -53 -53 -55 -55 -55 -53 -55 
-59 -55 -59 -57 -57 -55 -53 -55 -53 -57 
-57 -59 -59 -61 -59 -59 -57 -59 -57 -59 
-55 -57 -55 -57 -55 -57 -57 -59 -57 -57 
-57 -57 -55 -59 -57 -59 -59 -59 -57 -59 
-59 -59 -57 -59 -57 -59 -59 -59 -59 -59 
-57 -59 -57 -57 -59 -59 -59 -59 -57 -59 
-59 -59 -57 -57 -57 -59 -57 -57 -57 -59 
-61 -57 -57 -59 -57 -57 -57 -59 -57 -59 
-59 -59 -59 -57 -59 -57 -59 -59 -63 -61 
-57 -57 -59 -57 -59 -57 -57 -59 -59 -59 
-59 -57 -57 -59 -59 -57 -59 -59 -59 -59 
-59 -59 -57 -59 -59 -59 -57 -57 -59 -57 
-59 -57 -59 -57 -59 -57 -59 -57 -59 -57 
-59 -57 -59 -57 -59 -57 -59 -59 -79 -59 
-59 -59 -57 -67 -67 -59 -59 -59 -59 -59 
-59 -61 -59 -59 -57 -59 -57 -59 -57 -59 
-57 -59 -59 -61 -59 -57 -59 -57 -59 -57 
-59 -61 -57 -59 -59 -61 -59 -59 -59 -59 
-57 -59 -59 -59 -59 -59 -59 -59 -59 -61 
-59 -59 -57 -59 -59 -59 -61 -59 -59 -59 
-59 -59 -59 -57 -59 -59 -59 -59 -59 -59 
-59 -59 -61 -59 -59 -59 -59 -57 -89 -91 
-59 -59 -57 -59 -57 -59 -59 -59 -59 -59 
-57 -59 -57 -59 -57 -59 -55 -57 -57 -59 
-57 -59 -59 -61 -57 -63 -59 -59 -59 -59 
-59 -59 -59 -59 -59 -59 -59 -57 -59 -57 
-59 -57 -59 -59 -61 -59 -59 -57 -59 -59 
-61 -57 -59 -59 -59 -59 -59 -59 -59 -59 
-59 -59 -59 -61 -59 -59 -59 -59 -59 -59 
-59 -59 -59 -59 -57 -59 -57 -59 -59 -59 
-59 -59 -55 -59 -59 -59 -57 -59 -59 -59 
-59 -57 -59 -57 -59 -57 -59 -57 -59 -57 
-59 -59 -59 -59 -57 -59 -59 -57 -57 -57 
-57 -59 -57 -59 -59 -59 -57 -59 -57 -59 
-59 -61 -57 -57 -55 -61 -57 -59 -57 -59 
-57 -59 -59 -59 -59 -59 -59 -61 -59 -59 
