-33 -33 -35 -35 -33 -33 -33 -33 -33 -33 
-33 -33 -33 -33 -33 -33 -33 -35 -33 -35 
-33 -33 -33 -33 -33 -33 -33 -33 -33 -33 
-33 -35 -33 -35 -35 -31 -31 -89 -31 -31 
-31 -31 -31 -31 -31 -31 -31 -31 -31 -31 
-31 -31 -31 -31 -31 -31 -31 -31 -31 -31 
-31 -31 -31 -31 -31 -31 -31 -31 -31 -31 
-31 -31 -31 -31 -31 -31 -31 -31 -31 -31 
-31 -31 -31 -33 -33 -33 -33 -33 -33 -33 
-33 -33 -33 -33 -33 -33 -55 -33 -33 -33 
-33 -33 -33 -33 -35 -35 -35 -35 -35 -35 
-35 -33 -35 -35 -33 -35 -35 -35 -35 -35 
-35 -35 -35 -35 -35 -35 -35 -33 -35 -33 
-33 -33 -33 -35 -35 -35 -35 -35 -35 -35 
-35 -35 -35 -35 -35 -35 -35 -35 -35 -35 
-35 -35 -35 -35 -35 -35 -35 -35 -35 -35 
-35 -33 -35 -35 -35 -35 -35 -35 -35 -35 
-35 -35 -35 -35 -35 -35 -33 -35 -35 -35 
-33 -35 -35 -35 -35 -35 -33 -33 -35 -35 
-35 -71 -35 -35 -35 -33 -35 -35 -35 -35 
-35 -35 -35 -35 -35 -35 -35 -35 -35 -35 
-35 -35 -35 -57 -37 -37 -37 -37 -33 -37 
-35 -35 -33 -37 -35 -35 -35 -35 -35 -35 
-33 -35 -35 -35 -35 -35 -35 -35 -35 -35 
-35 -35 -37 -35 -37 -35 -35 -35 -35 -35 
-35 -35 -35 -35 -35 -35 -37 -35 -35 -35 
-35 -35 -35 -35 -35 -33 -35 -35 -33 -91 
-33 -33 -35 -37 -33 -33 -33 -35 -35 -37 
-35 -89 -35 -35 -35 -33 -35 -33 -91 -33 
-35 -35 -35 -35 -35 -31 -33 -35 -35 -33 
-35 -33 -35 -35 -35 -35 -35 -35 -35 -35 
-35 -35 -35 -35 -35 -35 -35 -35 -35 -35 
-35 -35 -35 -35 -35 -35 -35 -35 -35 -35 
-33 -33 -35 -35 -35 -33 -33 -35 -35 -35 
-33 -35 -33 -35 -35 -35 -35 -33 -33 -33 
-33 -33 -31 -33 -33 -35 -35 -35 -37 -33 
-33 -35 -33 -35 -33 -35 -35 -35 -35 -33 
-35 -35 -33 -33 -33 -33 -35 -35 -35 -35 
-35 -33 -33 -35 -35 -35 -35 -35 -35 -33 
-35 -35 -35 -35 -35 -35 -35 -35 -35 -33 
-33 -35 -33 -33 -33 -33 -33 -33 -33 -35 
-35 -35 -35 -35 -35 -35 -35 -35 -35 -35 
-35 -33 -33 -35 -33 -33 -33 -35 -35 -35 
-35 -35 -35 -33 -35 -35 -33 -33 -31 -31 
-35 -35 -33 -33 -33 -33 -35 -35 -35 -35 
-33 -33 -35 -35 -35 -35 -35 -35 -35 -35 
-35 -35 -35 -35 -35 -35 -33 -33 -33 -33 
-33 -33 -33 -33 -33 -33 -35 -33 -33 -35 
-35 -35 -35 -35 -35 -35 -91 -33 -33 -33 
-35 -33 -33 -35 -35 -33 -33 -33 -33 -35 
-35 -35 -35 -35 -35 -35 -35 -33 -33 -35 
-35 -35 -35 -35 -35 -33 -33 -35 -35 -33 
-33 -33 -35 -35 -33 -33 -33 -33 -35 -35 
-33 -33 -35 -35 -33 -31 -33 -35 -35 -35 
-33 -33 -33 -35 -35 -35 -33 -35 -35 -33 
-35 -33 -33 -35 -35 -35 -35 -35 -35 -35 
-35 -35 -35 -33 -33 -35 -35 -33 -35 -33 
-33 -35 -35 -35 -35 -35 -35 -35 -35 -35 
-35 -35 -35 -89 -35 -35 -35 -33 -35 -33 
-33 -33 -35 -35 -33 -33 -35 -35 -35 -35 
-35 -35 -33 -33 -35 -35 -35 -35 -35 -35 
-35 -35 -35 -35 -33 -35 -35 -35 -35 -33 
-33 -35 -33 -35 -35 -35 -35 -35 -35 -33 
-33 -35 -33 -35 -35 -35 -37 -33 -33 -33 
-33 -35 -33 -35 -35 -33 -85 -35 -33 -33 
-35 -35 -35 -33 -33 -33 -33 -33 -35 -33 
-33 -33 -33 -33 -35 -33 -33 -33 -33 -33 
-33 -33 -33 -35 -33 -33 -35 -35 -33 -33 
-35 -33 -35 -35 -33 -35 -33 -35 -35 -35 
-35 -35 -35 -35 -35 -35 -33 -33 -35 -35 
-35 -35 -35 -35 -35 -35 -35 -35 -35 -35 
-35 -35 -35 -35 -35 -35 -33 -35 -33 -35 
-35 -35 -35 -35 -33 -33 -35 -35 -33 -33 
-33 -33 -35 -35 -33 -33 -33 -33 -35 -35 
-35 -35 -35 -35 -35 -35 -35 -35 -91 -35 
-33 -35 -35 -33 -33 -33 -33 -33 -35 -35 
-31 -33 -33 -33 -33 -35 -35 -33 -35 -33 
-33 -35 -35 -35 -35 -33 -33 -35 -33 -33 
-35 -35 -35 -35 -35 -35 -33 -33 -35 -35 
-35 -35 -35 -33 -35 -35 -35 -35 -35 -35 
-35 -33 -35 -33 -35 -33 -35 -33 -33 -33 
-35 -35 -35 -35 -35 -33 -35 -33 -35 -35 
-35 -35 -35 -35 -33 -35 -35 -35 -35 -35 
-35 -35 -33 -33 -33 -33 -33 -33 -35 -33 
-31 -35 -33 -35 -35 -35 -35 -33 -33 -35 
-33 -35 -35 -35 -33 -35 -35 -33 -33 -33 
-33 -35 -35 -35 -35 -33 -35 -35 -57 -57 
-35 -35 -35 -35 -35 -33 -35 -35 -35 -35 
-35 -35 -35 -35 -35 -35 -35 -35 -35 -35 
-35 -35 -35 -35 -35 -35 -35 -35 -35 -35 
-35 -35 -35 -35 -35 -33 -35 -33 -33 -33 
-35 -35 -33 -33 -33 -33 -35 -33 -35 -33 
-35 -35 -35 -35 -35 -33 -33 -33 -33 -33 
-35 -35 -33 -33 -33 -35 -35 -35 -59 -35 
-35 -35 -35 -35 -35 -35 -35 -35 -35 -33 
-35 -37 -35 -35 -35 -35 -35 -35 -35 -35 
-35 -35 -35 -35 -35 -71 -71 -35 -35 -35 
-35 -35 -35 -35 -35 -33 -35 -35 -35 -35 
-35 -35 -35 -35 -35 -35 -35 -35 -35 -33 
-35 -35 -35 -35 -35 -35 -91 -33 -35 -35 
-35 -35 -33 -33 -35 -33 -35 -33 -35 -35 
-35 -33 -33 -33 -35 -35 -33 -35 -35 -35 
-35 -35 -35 -33 -35 -33 -35 -33 -33 -33 
-35 -35 -35 -35 -35 -35 -35 -35 -35 -35 
-33 -33 -35 -35 -33 -33 -33 -31 -33 -33 
-33 -33 -35 -35 -35 -35 -35 -35 -35 -35 
-35 -35 -35 -35 -35 -35 -35 -35 -35 -35 
-35 -35 -35 -35 -35 -37 -35 -35 -35 -33 
-91 -33 -37 -37 -35 -35 -37 -35 -35 -35 
-35 -35 -35 -37 -35 -37 -35 -35 -35 -35 
-35 -35 -35 -37 -35 -37 -35 -35 -35 -37 
-35 -37 -35 -37 -35 -35 -91 -37 -35 -35 
-35 -37 -35 -35 -35 -35 -35 -35 -35 -35 
-35 -35 -35 -35 -35 -35 -35 -35 -37 -35 
-37 -35 -35 -35 -35 -35 -35 -31 -31 -33 
-35 -35 -35 -35 -35 -33 -35 -35 -35 -35 
-35 -35 -35 -35 -89 -89 -35 -35 -35 -35 
-35 -35 -35 -35 -35 -35 -35 -35 -35 -35 
-35 -35 -35 -35 -35 -35 -35 -35 -35 -35 
-35 -35 -35 -35 -35 -35 -35 -35 -35 -35 
-35 -35 -35 -35 -35 -35 -35 -35 -35 -35 
-35 -35 -35 -35 -35 -35 -35 -35 -35 -35 
-35 -35 -35 -35 -35 -35 -35 -35 -35 -35 
-35 -35 -35 -35 -35 -35 -35 -33 -71 -33 
-35 -85 -85 -35 -35 -35 -35 -35 -35 -35 
-35 -33 -35 -35 -35 -35 -35 -35 -35 -35 
-35 -35 -35 -35 -35 -35 -35 -35 -35 -35 
-35 -35 -33 -31 -91 -53 -35 -35 -35 -35 
-35 -35 -35 -35 -35 -35 -35 -35 -35 -35 
-35 -35 -35 -35 -35 -35 -35 -35 -35 -35 
-35 -35 -33 -35 -35 -35 -35 -35 -35 -35 
-35 -35 -37 -35 -35 -35 -35 -35 -35 -35 
-35 -35 -35 -35 -35 -35 -35 -35 -35 -35 
-35 -35 -35 -35 -35 -35 -33 -35 -35 -35 
-35 -35 -33 -33 -33 -33 -33 -33 -33 -33 
-33 -33 -33 -33 -33 -33 -33 -33 -33 -33 
-33 -35 -35 -35 -35 -35 -35 -35 -35 -35 
-35 -35 -35 -35 -35 -35 -35 -35 -35 -35 
-35 -35 -35 -35 -35 -35 -35 -35 -35 -35 
-35 -35 -31 -33 -35 -35 -35 -35 -35 -35 
-35 -35 -35 -35 -35 -35 -35 -33 -35 -35 
-35 -35 -35 -33 -35 -35 -35 -35 -35 -35 
-35 -35 -35 -35 -35 -35 -35 -35 -35 -35 
-35 -35 -35 -35 -35 -35 -35 -35 -35 -35 
-35 -35 -35 -33 -35 -37 -35 -35 -35 -35 
-35 -35 -35 -35 -35 -35 -35 -35 -35 -35 
-35 -35 -35 -35 -35 -35 -35 -35 -35 -35 
-35 -35 -35 -35 -35 -35 -35 -35 -35 -35 
-35 -35 -35 -33 -35 -35 -35 -35 -35 -35 
-35 -35 -35 -35 -35 -35 -35 -35 -33 -33 
-35 -35 -35 -35 -35 -35 -35 -35 -35 -35 
-35 -35 -35 -35 -35 -35 -35 -35 -35 -35 
-35 -35 -35 -33 -35 -35 -35 -35 -35 -35 
-35 -35 -35 -35 -35 -35 -35 -35 -35 -35 
-35 -35 -35 -35 -35 -35 -35 -35 -33 -33 
-33 -33 -33 -33 -33 -33 -33 -33 -33 -33 
-33 -33 -33 -33 -33 -33 -33 -33 -33 -33 
-33 -33 -33 -33 -33 -33 -33 -33 -33 -33 
-33 -33 -33 -31 -61 -35 -35 -35 -35 -35 
-35 -35 -35 -35 -35 -35 -33 -33 -35 -35 
-35 -33 -35 -35 -35 -35 -35 -35 -35 -35 
-35 -35 -35 -35 -35 -35 -35 -35 -35 -35 
-35 -35 -35 -35 -35 -35 -35 -35 -35 -35 
-35 -33 -35 -35 -35 -35 -35 -37 -35 -35 
-35 -35 -37 -87 -35 -35 -35 -35 -35 -35 
-35 -35 -35 -35 -35 -35 -35 -35 -35 -35 
-35 -35 -35 -35 -35 -35 -35 -35 -35 -35 
-35 -35 -35 -35 -35 -35 -35 -35 -35 -35 
-35 -35 -35 -35 -35 -35 -35 -35 -35 -35 
-35 -33 -35 -35 -35 -35 -35 -35 -35 -35 
-35 -35 -35 -35 -35 -35 -35 -35 -35 -35 
-35 -35 -35 -35 -35 -35 -35 -35 -35 -35 
-35 -35 -35 -37 -35 -35 -35 -35 -35 -35 
-35 -35 -35 -35 -35 -35 -35 -35 -35 -35 
-35 -35 -35 -35 -35 -35 -35 -35 -35 -35 
-35 -35 -35 -35 -85 -35 -35 -35 -35 -35 
-35 -35 -35 -35 -35 -35 -87 -35 -35 -35 
-35 -35 -35 -35 -35 -35 -35 -35 -35 -35 
-35 -35 -35 -35 -35 -35 -35 -35 -35 -33 
-35 -35 -35 -35 -35 -33 -35 -35 -35 -35 
-35 -35 -35 -35 -35 -35 -35 -35 -35 -35 
-35 -35 -35 -35 -35 -35 -35 -35 -35 -35 
-35 -35 -35 -35 -35 -35 -35 -35 -35 -35 
-35 -35 -35 -35 -35 -35 -35 -35 -35 -33 
-35 -35 -35 -35 -35 -37 -35 -35 -35 -35 
-35 -35 -35 -35 -35 -35 -35 -35 -33 -35 
-35 -35 -35 -35 -35 -35 -35 -35 -35 -35 
-35 -35 -35 -35 -35 -35 -35 -35 -35 -35 
-35 -35 -35 -35 -35 -35 -35 -35 -35 -35 
-35 -35 -37 -35 -35 -35 -35 -35 -35 -35 
-35 -35 -35 -35 -35 -35 -35 -35 -35 -35 
-35 -35 -35 -61 -61 -35 -35 -35 -35 -35 
-35 -35 -35 -35 -35 -33 -35 -35 -35 -35 
-35 -35 -35 -35 -35 -37 -35 -35 -35 -35 
-35 -35 -35 -35 -35 -35 -35 -35 -35 -35 
-35 -35 -35 -35 -35 -35 -35 -35 -35 -35 
-35 -35 -35 -35 -35 -35 -33 -35 -35 -35 
-35 -35 -35 -35 -35 -35 -35 -35 -35 -35 
-35 -35 -91 -35 -35 -35 -35 -35 -35 -35 
-35 -35 -35 -35 -33 -33 -35 -33 -35 -35 
-35 -35 -35 -35 -35 -35 -35 -35 -35 -33 
-35 -33 -35 -35 -35 -35 -35 -35 -35 -35 
-35 -35 -35 -35 -35 -35 -35 -35 -35 -35 
-35 -35 -35 -35 -35 -35 -35 -35 -35 -35 
-35 -35 -35 -33 -35 -35 -35 -35 -35 -35 
-35 -35 -35 -35 -35 -35 -35 -35 -35 -35 
-35 -35 -35 -35 -35 -35 -35 -35 -35 -35 
-35 -35 -35 -35 -35 -35 -35 -35 -35 -35 
-35 -35 -35 -35 -33 -35 -35 -35 -35 -35 
-33 -35 -35 -35 -35 -35 -35 -35 -35 -35 
-35 -35 -35 -35 -35 -33 -35 -35 -35 -53 
-35 -35 -35 -33 -35 -35 -35 -35 -35 -35 
-35 -35 -35 -35 -35 -35 -35 -35 -35 -35 
-35 -35 -35 -35 -35 -35 -35 -35 -35 -35 
-91 -33 -35 -35 -35 -35 -35 -35 -35 -35 
-35 -35 -35 -35 -35 -35 -35 -35 -35 -35 
-35 -35 -35 -35 -35 -35 -35 -35 -35 -35 
-35 -35 -35 -35 -35 -35 -35 -35 -35 -35 
-35 -35 -35 -35 -71 -35 -33 -35 -35 -35 
-35 -35 -35 -35 -35 -35 -35 -35 -35 -35 
-35 -35 -35 -35 -35 -35 -35 -35 -35 -35 
-37 -35 -35 -35 -35 -35 -35 -35 -35 -35 
-35 -35 -35 -35 -35 -35 -35 -35 -35 -35 
-35 -35 -35 -35 -35 -33 -35 -35 -35 -35 
-35 -35 -35 -35 -35 -35 -35 -35 -35 -35 
-35 -35 -35 -37 -35 -35 -35 -35 -35 -35 
-35 -35 -35 -35 -35 -35 -35 -35 -35 -35 
-35 -35 -35 -35 -35 -35 -33 -35 -35 -35 
-35 -35 -35 -35 -33 -35 -35 -35 -35 -35 
-35 -35 -33 -35 -35 -35 -35 -35 -35 -35 
-35 -35 -35 -35 -35 -35 -35 -37 -33 -35 
-35 -35 -35 -35 -35 -35 -35 -35 -33 -35 
-35 -35 -35 -35 -35 -35 -35 -35 -35 -35 
-33 -35 -33 -33 -35 -33 -35 -35 -35 -35 
-35 -35 -35 -35 -35 -35 -35 -35 -35 -35 
-35 -35 -35 -35 -35 -35 -35 -35 -35 -35 
-35 -35 -35 -35 -35 -35 -35 -35 -35 -35 
-35 -35 -35 -35 -35 -35 -35 -35 -35 -35 
-35 -35 -35 -35 -35 -35 -35 -35 -35 -35 
-35 -35 -35 -35 -35 -35 -35 -35 -35 -35 
-35 -35 -33 -35 -35 -35 -35 -35 -35 -35 
-35 -35 -35 -35 -35 -35 -35 -35 -35 -35 
-71 -35 -35 -35 -35 -35 -35 -35 -35 -35 
-35 -35 -35 -35 -35 -35 -35 -35 -35 -35 
-35 -35 -35 -35 -35 -35 -35 -35 -35 -73 
-35 -35 -35 -35 -35 -35 -35 -35 -35 -35 
-35 -35 -35 -35 -35 -35 -35 -35 -35 -35 
-33 -35 -35 -35 -35 -35 -35 -35 -35 -35 
-35 -35 -35 -35 -35 -35 -35 -35 -35 -35 
-35 -37 -35 -35 -35 -35 -35 -35 -35 -35 
-35 -35 -35 -35 -35 -35 -37 -35 -35 -35 
-35 -35 -37 -35 -35 -35 -35 -35 -35 -35 
-35 -35 -35 -35 -35 -35 -35 -35 -35 -35 
-35 -35 -57 -57 -35 -35 -35 -35 -35 -35 
-35 -35 -35 -35 -35 -35 -35 -35 -35 -35 
-35 -35 -33 -35 -37 -35 -35 -35 -35 -35 
-35 -35 -35 -35 -35 -35 -35 -35 -35 -35 
-35 -35 -35 -35 -37 -35 -35 -35 -35 -35 
-35 -33 -35 -35 -35 -35 -35 -35 -35 -35 
-35 -35 -33 -35 -53 -35 -37 -35 -35 -91 
-35 -33 -35 -35 -35 -33 -35 -33 -35 -35 
-35 -35 -35 -35 -35 -35 -35 -35 -35 -35 
-33 -33 -33 -35 -35 -35 -33 -35 -35 -35 
-35 -35 -35 -35 -37 -35 -35 -35 -35 -35 
-35 -35 -35 -35 -35 -35 -35 -37 -35 -35 
-35 -35 -35 -35 -35 -35 -35 -35 -35 -35 
-35 -35 -35 -35 -35 -35 -35 -35 -35 -35 
-35 -35 -35 -35 -35 -35 -35 -35 -35 -35 
-35 -35 -35 -35 -35 -35 -35 -35 -35 -35 
-35 -35 -35 -35 -35 -35 -35 -37 -35 -35 
-35 -37 -35 -35 -35 -35 -35 -35 -35 -35 
-35 -35 -35 -35 -35 -35 -35 -35 -71 -71 
-35 -35 -35 -35 -35 -35 -35 -35 -35 -35 
-35 -91 -35 -35 -35 -33 -35 -33 -35 -33 
-35 -37 -35 -35 -35 -35 -35 -35 -35 -33 
-35 -35 -35 -37 -35 -35 -35 -35 -35 -35 
-35 -35 -35 -35 -35 -35 -35 -35 -35 -35 
-35 -35 -35 -35 -35 -35 -35 -35 -35 -35 
-35 -35 -35 -37 -35 -35 -35 -35 -35 -35 
-35 -33 -35 -35 -37 -91 -35 -35 -35 -35 
-35 -33 -35 -35 -35 -35 -35 -35 -35 -35 
-35 -35 -35 -35 -35 -35 -35 -35 -35 -35 
-35 -35 -35 -35 -35 -35 -35 -35 -35 -35 
-33 -35 -35 -35 -35 -35 -35 -35 -37 -35 
-33 -35 -35 -35 -35 -35 -35 -37 -35 -35 
-35 -35 -35 -35 -35 -37 -35 -35 -35 -35 
-35 -35 -35 -35 -35 -35 -35 -35 -35 -35 
-35 -33 -35 -35 -35 -35 -35 -35 -35 -35 
-35 -35 -35 -35 -35 -35 -35 -35 -37 -35 
-35 -35 -35 -35 -35 -87 -35 -35 -35 -35 
-35 -35 -35 -35 -35 -33 -35 -35 -35 -35 
-35 -35 -35 -35 -35 -35 -35 -35 -35 -33 
-35 -35 -35 -35 -35 -35 -35 -35 -51 -51 
-35 -35 -35 -35 -35 -35 -35 -35 -35 -35 
-35 -35 -35 -35 -35 -35 -35 -35 -35 -35 
-35 -35 -35 -35 -35 -35 -35 -35 -37 -35 
-35 -35 -35 -33 -33 -35 -35 -35 -35 -35 
-35 -35 -33 -35 -35 -35 -35 -35 -35 -35 
-35 -35 -35 -35 -35 -37 -35 -37 -35 -35 
-35 -35 -35 -35 -35 -35 -35 -35 -33 -35 
