-57 -57 -57 -57 -57 -59 -57 -59 -59 -57 
-57 -57 -57 -57 -57 -59 -59 -59 -57 -59 
-59 -59 -57 -59 -57 -57 -57 -59 -59 -61 
-61 -61 -63 -61 -61 -61 -61 -61 -61 -61 
-61 -63 -63 -63 -61 -63 -65 -61 -61 -65 
-67 -65 -65 -67 -69 -67 -69 -71 -75 -65 
-63 -67 -67 -65 -63 -69 -69 -65 -63 -65 
-63 -69 -67 -71 -69 -67 -63 -65 -65 -69 
-65 -65 -65 -65 -61 -59 -65 -63 -61 -61 
-65 -67 -61 -61 -61 -59 -63 -61 -61 -61 
-65 -61 -65 -63 -65 -63 -63 -61 -61 -61 
-61 -59 -63 -61 -63 -61 -63 -61 -63 -63 
-59 -63 -61 -65 -61 -63 -61 -61 -61 -61 
-61 -61 -59 -61 -61 -61 -61 -63 -63 -63 
-59 -63 -59 -65 -63 -63 -63 -61 -63 -61 
-63 -59 -61 -59 -63 -61 -61 -59 -61 -61 
-63 -63 -61 -59 -61 -61 -61 -61 -61 -59 
-61 -59 -61 -59 -63 -59 -63 -61 -61 -61 
-63 -59 -63 -63 -61 -61 -63 -61 -63 -61 
-63 -61 -61 -61 -61 -61 -61 -61 -61 -63 
-61 -69 -67 -63 -59 -63 -61 -63 -61 -63 
-61 -63 -61 -63 -63 -61 -63 -59 -63 -61 
-63 -61 -63 -63 -61 -61 -59 -91 -59 -63 
-61 -61 -59 -61 -59 -61 -59 -61 -63 -61 
-63 -61 -63 -61 -61 -59 -61 -59 -63 -59 
-63 -63 -61 -61 -61 -63 -59 -59 -63 -59 
-63 -61 -63 -63 -63 -61 -63 -61 -61 -61 
-63 -63 -61 -63 -63 -61 -61 -61 -61 -63 
-61 -63 -91 -63 -61 -61 -61 -63 -61 -61 
-61 -63 -61 -63 -59 -63 -61 -61 -59 -63 
-59 -61 -59 -61 -61 -61 -61 -63 -61 -63 
-61 -63 -63 -63 -61 -61 -61 -61 -63 -61 
-63 -63 -63 -61 -61 -63 -59 -63 -61 -61 
-61 -63 -59 -63 -61 -61 -61 -63 -61 -63 
-61 -63 -59 -61 -59 -63 -63 -63 -59 -61 
-61 -63 -59 -63 -63 -63 -61 -63 -61 -63 
-61 -63 -61 -63 -61 -63 -61 -63 -61 -63 
-63 -63 -59 -63 -63 -63 -61 -63 -61 -63 
-61 -61 -61 -63 -63 -63 -61 -63 -63 -63 
-61 -61 -61 -63 -63 -61 -59 -63 -61 -63 
-63 -63 -61 -63 -61 -63 -61 -63 -63 -63 
-61 -63 -63 -61 -63 -59 -61 -61 -63 -59 
-63 -61 -63 -61 -63 -61 -63 -59 -63 -61 
-63 -61 -63 -61 -63 -61 -63 -61 -63 -61 
-63 -61 -63 -61 -63 -61 -63 -61 -63 -61 
-63 -63 -61 -63 -63 -63 -61 -63 -61 -61 
-63 -63 -63 -61 -59 -61 -61 -61 -59 -63 
-61 -63 -59 -87 -61 -61 -61 -59 -61 -59 
-61 -59 -63 -61 -61 -63 -63 -63 -63 -59 
-63 -63 -63 -63 -61 -61 -63 -61 -63 -61 
-63 -59 -63 -61 -63 -61 -63 -63 -61 -61 
-59 -61 -59 -61 -61 -63 -61 -63 -61 -63 
-61 -61 -59 -63 -61 -61 -61 -61 -59 -63 
-61 -61 -59 -61 -59 -67 -67 -61 -61 -63 
-61 -59 -61 -61 -63 -61 -63 -59 -65 -63 
-61 -61 -61 -61 -63 -61 -61 -59 -63 -61 
-63 -59 -63 -61 -63 -61 -61 -59 -63 -61 
-63 -61 -63 -61 -65 -61 -65 -61 -65 -61 
-63 -61 -63 -61 -61 -61 -63 -61 -61 -61 
-61 -59 -61 -59 -61 -59 -61 -61 -63 -59 
-63 -61 -63 -61 -63 -65 -63 -67 -65 -65 
-63 -67 -65 -65 -63 -65 -65 -63 -63 -63 
-63 -61 -65 -61 -61 -61 -59 -63 -61 -65 
-63 -65 -63 -89 -61 -63 -63 -63 -61 -63 
-59 -63 -61 -61 -61 -61 -59 -59 -63 -59 
-63 -61 -63 -61 -63 -63 -61 -61 -61 -59 
-63 -61 -65 -61 -63 -61 -63 -61 -63 -59 
-61 -59 -67 -65 -59 -59 -65 -65 -65 -63 
-67 -63 -65 -65 -63 -69 -67 -65 -69 -69 
-67 -65 -65 -67 -69 -61 -59 -61 -61 -63 
-65 -69 -69 -63 -61 -61 -61 -61 -63 -63 
-65 -61 -63 -65 -63 -65 -67 -65 -63 -63 
-61 -63 -59 -57 -61 -91 -59 -63 -61 -61 
-59 -61 -59 -61 -59 -63 -59 -63 -61 -71 
-71 -67 -69 -65 -67 -65 -69 -67 -65 -63 
-65 -63 -67 -67 -69 -71 -69 -71 -67 -73 
-65 -69 -65 -63 -65 -61 -69 -69 -65 -65 
-65 -61 -67 -65 -69 -73 -69 -71 -67 -67 
-89 -67 -63 -65 -63 -67 -71 -71 -69 -67 
-63 -71 -65 -67 -67 -67 -67 -67 -65 -67 
-69 -65 -65 -69 -65 -63 -69 -63 -67 -63 
-69 -65 -67 -69 -63 -63 -61 -59 -63 -61 
-65 -67 -69 -73 -69 -71 -69 -69 -69 -67 
-63 -61 -59 -59 -63 -59 -65 -67 -65 -63 
-65 -63 -63 -61 -61 -61 -59 -59 -55 -59 
-57 -59 -57 -59 -57 -61 -59 -63 -63 -67 
-71 -63 -61 -69 -69 -67 -65 -71 -69 -67 
-67 -65 -69 -71 -63 -59 -61 -61 -63 -61 
-69 -65 -65 -63 -67 -63 -63 -61 -65 -61 
-63 -61 -61 -59 -61 -61 -63 -61 -63 -63 
-65 -61 -63 -61 -63 -61 -61 -59 -61 -59 
-63 -59 -63 -61 -63 -61 -65 -63 -61 -61 
-61 -61 -59 -61 -61 -61 -59 -59 -57 -63 
-59 -61 -59 -61 -59 -61 -61 -63 -61 -91 
-61 -67 -65 -61 -61 -63 -63 -61 -63 -61 
-63 -63 -59 -61 -61 -61 -61 -61 -61 -63 
-63 -63 -61 -63 -61 -65 -63 -65 -61 -65 
-63 -63 -63 -59 -63 -63 -65 -63 -65 -65 
-65 -63 -63 -63 -63 -63 -63 -65 -63 -65 
-65 -65 -65 -67 -65 -63 -67 -69 -69 -69 
-67 -51 -67 -67 -69 -71 -67 -71 -65 -65 
-65 -65 -67 -63 -67 -65 -67 -65 -67 -65 
-69 -67 -91 -65 -69 -67 -69 -67 -69 -69 
-69 -67 -69 -67 -69 -67 -69 -65 -69 -67 
-63 -59 -61 -61 -65 -63 -63 -61 -65 -63 
-63 -63 -65 -63 -65 -67 -67 -69 -67 -69 
-69 -69 -73 -71 -73 -73 -71 -73 -71 -71 
-71 -71 -71 -71 -69 -71 -71 -73 -69 -69 
-67 -67 -69 -71 -73 -73 -73 -71 -71 -71 
-71 -69 -71 -69 -69 -71 -69 -69 -69 -71 
-71 -71 -69 -69 -71 -69 -69 -69 -69 -65 
-61 -61 -63 -59 -63 -65 -67 -65 -65 -67 
-67 -67 -65 -65 -65 -65 -65 -67 -65 -67 
-67 -67 -65 -67 -67 -67 -67 -67 -67 -67 
-93 -67 -67 -65 -67 -67 -67 -65 -67 -69 
-67 -67 -67 -67 -67 -67 -67 -65 -67 -65 
-65 -67 -65 -67 -65 -65 -67 -65 -65 -65 
-65 -65 -65 -65 -65 -65 -65 -65 -65 -65 
-65 -65 -65 -65 -67 -65 -67 -67 -67 -67 
-67 -67 -67 -69 -67 -67 -69 -67 -67 -67 
-67 -67 -69 -67 -67 -67 -67 -67 -69 -69 
-67 -69 -69 -69 -67 -69 -69 -69 -67 -67 
-67 -65 -67 -67 -67 -67 -67 -65 -67 -67 
-67 -67 -67 -65 -65 -67 -65 -67 -67 -65 
-67 -67 -67 -67 -67 -67 -67 -67 -67 -67 
-67 -67 -67 -89 -63 -65 -63 -65 -65 -63 
-63 -63 -63 -63 -67 -65 -63 -65 -67 -65 
-65 -67 -65 -65 -63 -63 -65 -65 -63 -63 
-63 -63 -61 -63 -65 -63 -63 -63 -63 -63 
-61 -63 -63 -63 -63 -63 -65 -61 -65 -63 
-65 -61 -63 -63 -65 -65 -63 -65 -65 -65 
-63 -65 -65 -65 -65 -63 -63 -63 -63 -65 
-65 -65 -65 -65 -65 -63 -63 -65 -63 -63 
-65 -63 -59 -59 -59 -55 -57 -57 -57 -59 
-55 -59 -57 -57 -59 -59 -59 -59 -57 -57 
-57 -59 -57 -59 -59 -59 -59 -59 -57 -57 
-57 -57 -59 -57 -55 -55 -61 -59 -65 -63 
-65 -65 -65 -63 -63 -63 -61 -89 -61 -63 
-59 -63 -63 -63 -63 -63 -63 -63 -63 -65 
-65 -63 -63 -63 -63 -63 -61 -57 -57 -55 
-57 -57 -55 -55 -57 -59 -63 -65 -67 -67 
-73 -75 -67 -67 -61 -65 -63 -69 -67 -69 
-67 -69 -67 -91 -73 -69 -69 -73 -65 -61 
-67 -71 -69 -69 -71 -69 -71 -69 -67 -69 
-69 -65 -63 -67 -63 -65 -63 -67 -65 -67 
-69 -69 -67 -71 -67 -67 -63 -69 -69 -67 
-63 -69 -67 -67 -65 -91 -63 -69 -65 -71 
-69 -71 -69 -67 -65 -65 -63 -67 -65 -67 
-63 -63 -65 -61 -65 -63 -67 -63 -67 -91 
-67 -65 -67 -63 -65 -67 -67 -65 -67 -63 
-67 -63 -63 -67 -61 -65 -63 -67 -65 -67 
-63 -67 -67 -63 -67 -63 -65 -63 -67 -63 
-65 -65 -63 -65 -65 -65 -63 -65 -65 -65 
-61 -65 -63 -65 -63 -67 -65 -67 -65 -67 
-63 -67 -63 -67 -63 -65 -61 -67 -63 -67 
-65 -65 -67 -65 -65 -69 -65 -67 -63 -69 
-65 -67 -63 -69 -67 -65 -67 -65 -67 -63 
-67 -63 -65 -63 -67 -65 -65 -91 -65 -63 
-67 -65 -65 -65 -67 -67 -63 -67 -65 -65 
-63 -65 -67 -63 -67 -67 -67 -65 -63 -65 
-63 -65 -63 -67 -65 -67 -63 -67 -67 -63 
-67 -63 -67 -67 -65 -67 -65 -67 -67 -65 
-65 -65 -67 -65 -63 -65 -63 -65 -63 -67 
-67 -65 -67 -63 -65 -67 -65 -67 -65 -65 
-65 -67 -65 -65 -63 -63 -61 -67 -63 -67 
-63 -65 -65 -63 -65 -65 -65 -65 -65 -67 
-67 -63 -65 -65 -67 -65 -67 -63 -67 -67 
-65 -65 -65 -67 -61 -67 -63 -65 -65 -67 
-63 -67 -63 -67 -65 -67 -65 -65 -63 -67 
-61 -65 -63 -67 -65 -69 -65 -67 -65 -67 
-63 -67 -63 -67 -63 -67 -65 -67 -65 -65 
-65 -67 -65 -67 -63 -67 -63 -67 -65 -67 
-65 -67 -65 -67 -63 -67 -67 -67 -65 -65 
-67 -65 -67 -63 -67 -63 -67 -63 -67 -63 
-67 -67 -67 -65 -65 -65 -63 -63 -67 -63 
-67 -63 -67 -65 -67 -63 -67 -63 -67 -63 
-67 -65 -67 -67 -65 -67 -65 -65 -65 -67 
-65 -67 -63 -67 -65 -67 -65 -67 -65 -67 
-63 -65 -67 -67 -67 -65 -67 -63 -67 -67 
-67 -65 -67 -65 -67 -65 -67 -67 -63 -63 
-69 -65 -67 -65 -63 -63 -67 -65 -67 -63 
-67 -67 -67 -65 -63 -67 -63 -65 -61 -65 
-63 -65 -65 -65 -61 -65 -63 -63 -65 -63 
-65 -65 -63 -65 -65 -91 -65 -65 -67 -67 
-65 -67 -65 -69 -67 -69 -65 -67 -63 -65 
-67 -63 -65 -65 -61 -65 -61 -63 -67 -63 
-65 -65 -65 -63 -65 -63 -65 -63 -67 -63 
-67 -63 -65 -63 -67 -61 -65 -63 -65 -63 
-67 -63 -65 -63 -63 -65 -61 -65 -63 -67 
-61 -63 -67 -65 -65 -63 -65 -67 -65 -67 
-65 -69 -67 -65 -67 -65 -67 -67 -63 -91 
-63 -65 -65 -67 -67 -65 -63 -65 -65 -65 
-61 -67 -65 -67 -63 -69 -65 -65 -63 -69 
-65 -65 -65 -67 -65 -67 -65 -65 -63 -69 
-65 -69 -67 -67 -67 -65 -63 -65 -63 -61 
-61 -67 -67 -61 -59 -61 -63 -63 -65 -63 
-63 -63 -61 -61 -61 -59 -65 -65 -61 -61 
-61 -61 -63 -61 -61 -63 -61 -61 -59 -63 
-63 -63 -57 -59 -63 -59 -63 -61 -61 -59 
-67 -67 -63 -63 -61 -63 -63 -69 -67 -61 
-63 -63 -63 -61 -65 -65 -63 -63 -65 -65 
-63 -59 -65 -65 -67 -65 -69 -67 -65 -63 
-65 -69 -59 -59 -61 -59 -67 -65 -63 -63 
-59 -63 -65 -65 -63 -65 -67 -63 -61 -65 
-63 -65 -65 -67 -65 -65 -65 -63 -63 -63 
-63 -63 -63 -63 -63 -63 -63 -61 -65 -61 
-65 -63 -63 -63 -63 -63 -61 -65 -63 -63 
-63 -63 -65 -63 -65 -63 -65 -63 -63 -63 
-63 -63 -65 -63 -63 -63 -63 -63 -65 -65 
-63 -65 -63 -65 -63 -65 -91 -65 -65 -65 
-63 -65 -63 -65 -65 -65 -63 -65 -63 -65 
-65 -67 -65 -67 -63 -61 -63 -63 -61 -63 
-61 -61 -63 -63 -61 -63 -67 -61 -61 -61 
-63 -61 -61 -63 -63 -69 -69 -69 -69 -69 
-69 -69 -69 -67 -67 -69 -69 -67 -67 -67 
-69 -67 -65 -67 -71 -65 -67 -69 -65 -65 
-67 -65 -65 -67 -63 -67 -63 -65 -65 -65 
-65 -65 -65 -65 -63 -61 -59 -59 -65 -63 
-67 -63 -67 -67 -67 -69 -67 -67 -67 -65 
-65 -65 -65 -65 -65 -67 -67 -67 -65 -69 
-69 -67 -65 -63 -65 -67 -69 -69 -73 -67 
-63 -63 -63 -69 -75 -71 -71 -69 -67 -67 
-69 -65 -63 -65 -63 -63 -65 -67 -69 -65 
-65 -63 -69 -67 -67 -63 -67 -67 -65 -63 
-65 -63 -61 -57 -65 -61 -61 -59 -63 -61 
-65 -63 -59 -61 -71 -69 -63 -63 -61 -61 
-59 -63 -63 -61 -61 -61 -59 -81 -61 -61 
-59 -59 -59 -61 -61 -59 -61 -61 -61 -61 
-61 -63 -61 -65 -63 -61 -61 -65 -63 -59 
-63 -61 -59 -59 -59 -61 -57 -59 -61 -63 
-61 -63 -59 -63 -59 -59 -61 -61 -61 -63 
-61 -65 -63 -59 -65 -61 -65 -61 -63 -59 
-63 -61 -63 -59 -61 -61 -61 -61 -63 -59 
-61 -59 -61 -61 -63 -61 -61 -63 -63 -61 
-63 -61 -61 -61 -61 -61 -63 -59 -63 -63 
-61 -61 -61 -59 -63 -59 -59 -61 -59 -61 
-61 -59 -61 -59 -63 -61 -61 -61 -65 -61 
-59 -61 -61 -63 -61 -61 -61 -87 -61 -59 
-63 -59 -61 -61 -63 -61 -63 -61 -63 -61 
-63 -61 -61 -59 -63 -61 -63 -61 -61 -63 
-61 -63 -63 -61 -63 -63 -63 -61 -61 -61 
-63 -61 -63 -61 -61 -61 -63 -61 -63 -61 
-63 -59 -63 -59 -63 -63 -63 -61 -63 -63 
-63 -61 -61 -59 -61 -59 -61 -61 -63 -61 
-63 -63 -61 -61 -63 -61 -63 -61 -63 -61 
-61 -61 -63 -59 -63 -63 -61 -63 -61 -63 
-61 -63 -61 -63 -61 -63 -61 -63 -61 -61 
-61 -61 -61 -63 -63 -63 -61 -61 -63 -61 
-61 -63 -63 -91 -61 -63 -59 -63 -59 -63 
-61 -63 -61 -63 -61 -63 -61 -61 -61 -63 
-61 -63 -61 -63 -59 -59 -63 -61 -63 -61 
-63 -61 -63 -61 -63 -61 -61 -61 -61 -63 
-61 -63 -61 -63 -63 -65 -61 -63 -61 -63 
-63 -63 -61 -63 -61 -63 -61 -63 -61 -63 
-59 -61 -59 -63 -59 -63 -61 -63 -61 -63 
-61 -63 -61 -63 -61 -63 -61 -63 -61 -63 
-61 -63 -61 -63 -59 -63 -61 -63 -61 -63 
-59 -63 -63 -61 -61 -63 -59 -63 -59 -63 
-61 -63 -61 -63 -61 -63 -63 -63 -61 -63 
-61 -63 -63 -63 -61 -63 -61 -63 -61 -63 
-59 -63 -63 -61 -61 -63 -61 -61 -61 -63 
-61 -63 -61 -63 -61 -63 -59 -63 -61 -63 
-61 -63 -61 -63 -59 -63 -59 -63 -59 -63 
-61 -63 -61 -63 -61 -63 -61 -63 -63 -63 
-61 -63 -61 -63 -61 -63 -61 -63 -61 -63 
-61 -63 -59 -63 -61 -63 -63 -61 -63 -61 
-63 -63 -63 -61 -63 -63 -63 -61 -65 -63 
-61 -61 -63 -59 -63 -61 -63 -59 -63 -59 
-63 -63 -63 -61 -63 -61 -61 -63 -61 -63 
-89 -63 -61 -63 -59 -63 -59 -63 -61 -63 
-61 -63 -61 -63 -61 -63 -61 -63 -61 -63 
-61 -63 -59 -63 -61 -63 -61 -63 -61 -63 
-61 -63 -61 -63 -61 -63 -59 -63 -63 -63 
-59 -63 -61 -63 -61 -61 -63 -61 -63 -59 
-63 -61 -63 -61 -63 -59 -63 -61 -63 -61 
-63 -61 -63 -61 -63 -63 -61 -63 -63 -61 
-59 -63 -61 -63 -59 -63 -61 -91 -63 -61 
-63 -61 -69 -65 -63 -61 -63 -63 -63 -61 
-63 -61 -63 -61 -63 -61 -63 -61 -63 -61 
-61 -63 -59 -63 -63 -63 -59 -63 -61 -63 
-63 -63 -61 -63 -61 -63 -61 -63 -61 -63 
-61 -63 -59 -63 -61 -63 -61 -61 -61 -63 
-61 -63 -59 -63 -63 -61 -63 -63 -67 -67 
-63 -59 -63 -63 -63 -61 -63 -61 -63 -61 
-63 -61 -63 -59 -63 -61 -63 -61 -63 -61 
-63 -61 -63 -61 -63 -61 -63 -63 -59 -63 
-61 -63 -59 -63 -61 -63 -61 -63 -63 -63 
-61 -63 -61 -63 -61 -63 -61 -63 -61 -63 
-61 -63 -63 -63 -61 -69 -65 -63 -59 -63 
-63 -63 -61 -63 -61 -63 -61 -63 -59 -63 
-61 -63 -61 -63 -59 -61 -63 -61 -63 -59 
-63 -61 -63 -55 -63 -63 -59 -61 -63 -61 
-63 -61 -63 -61 -63 -61 -63 -59 -91 -63 
-61 -63 -59 -63 -61 -63 -61 -63 -61 -69 
-67 -63 -61 -63 -61 -63 -61 -63 -61 -63 
-61 -63 -59 -61 -63 -57 -61 -63 -63 -61 
-63 -59 -63 -61 -63 -59 -63 -61 -63 -61 
-63 -61 -61 -63 -87 -63 -63 -61 -63 -61 
-61 -61 -61 -63 -61 -63 -61 -63 -63 -63 
-63 -63 -61 -63 -61 -63 -63 -63 -61 -63 
