-45 -49 -47 -47 -43 -45 -45 -45 -47 -45 
-45 -43 -43 -45 -45 -45 -45 -43 -45 -45 
-43 -45 -45 -43 -45 -43 -45 -43 -45 -45 
-43 -45 -45 -47 -45 -45 -45 -45 -45 -47 
-45 -45 -45 -45 -45 -45 -43 -45 -45 -47 
-45 -47 -45 -47 -47 -45 -45 -45 -43 -45 
-89 -43 -43 -47 -89 -49 -47 -47 -45 -45 
-47 -45 -47 -45 -47 -45 -45 -45 -45 -43 
-43 -45 -45 -45 -43 -43 -45 -45 -45 -43 
-45 -43 -43 -43 -45 -43 -45 -45 -45 -45 
-43 -45 -45 -43 -45 -43 -45 -43 -75 -45 
-43 -45 -43 -45 -43 -45 -43 -43 -43 -43 
-43 -45 -45 -45 -43 -45 -45 -43 -43 -43 
-43 -45 -43 -45 -43 -43 -45 -43 -45 -43 
-43 -43 -45 -45 -45 -45 -45 -43 -45 -43 
-45 -43 -41 -45 -45 -43 -45 -45 -43 -45 
-45 -47 -47 -47 -45 -45 -43 -43 -45 -45 
-45 -43 -45 -45 -45 -45 -45 -43 -45 -43 
-45 -43 -45 -45 -45 -47 -45 -43 -45 -43 
-45 -43 -45 -43 -91 -45 -45 -45 -45 -47 
-45 -43 -43 -43 -45 -43 -45 -43 -45 -43 
-45 -43 -45 -45 -45 -45 -45 -43 -45 -43 
-45 -43 -45 -45 -45 -43 -45 -45 -45 -45 
-45 -45 -45 -45 -43 -45 -45 -45 -43 -45 
-43 -45 -45 -45 -45 -45 -43 -45 -43 -45 
-45 -45 -43 -45 -45 -45 -45 -45 -43 -45 
-45 -45 -45 -45 -43 -43 -45 -45 -43 -45 
-43 -45 -45 -45 -43 -45 -43 -45 -43 -45 
-43 -91 -45 -45 -89 -45 -43 -45 -45 -45 
-43 -45 -43 -45 -43 -45 -43 -45 -43 -45 
-43 -45 -45 -45 -43 -45 -43 -45 -45 -43 
-45 -45 -45 -47 -45 -45 -43 -45 -43 -45 
-43 -45 -45 -45 -43 -43 -43 -89 -43 -45 
-45 -51 -47 -45 -43 -45 -45 -45 -45 -45 
-45 -45 -43 -45 -45 -43 -45 -45 -45 -43 
-43 -43 -45 -43 -45 -43 -45 -45 -45 -43 
-45 -43 -45 -41 -43 -43 -45 -43 -45 -45 
-45 -43 -45 -45 -47 -45 -45 -45 -45 -47 
-47 -49 -49 -49 -47 -47 -45 -47 -45 -45 
-43 -43 -43 -45 -45 -45 -45 -45 -45 -45 
-43 -45 -43 -43 -45 -43 -43 -43 -41 -43 
-41 -43 -43 -43 -43 -43 -45 -45 -47 -45 
-47 -45 -45 -43 -45 -45 -45 -43 -45 -45 
-45 -45 -47 -45 -45 -45 -45 -45 -49 -47 
-45 -45 -45 -45 -45 -43 -43 -45 -45 -43 
-45 -43 -45 -43 -45 -45 -45 -45 -45 -43 
-45 -45 -45 -43 -45 -43 -45 -43 -45 -45 
-45 -43 -45 -45 -45 -45 -47 -43 -47 -45 
-45 -45 -43 -45 -45 -45 -45 -45 -45 -45 
-43 -45 -45 -45 -43 -45 -43 -45 -45 -43 
-45 -43 -45 -43 -45 -45 -45 -45 -45 -43 
-45 -43 -45 -43 -45 -43 -45 -43 -45 -45 
-45 -89 -41 -45 -91 -45 -43 -45 -45 -45 
-43 -45 -43 -45 -43 -45 -45 -45 -43 -45 
-43 -45 -45 -45 -45 -43 -45 -43 -45 -87 
-45 -43 -45 -43 -45 -43 -43 -43 -45 -43 
-43 -43 -45 -45 -45 -43 -43 -45 -91 -43 
-45 -43 -45 -43 -45 -45 -45 -43 -45 -45 
-45 -43 -45 -43 -45 -45 -45 -43 -45 -43 
-45 -43 -43 -43 -45 -43 -43 -43 -43 -45 
-43 -43 -43 -45 -43 -43 -43 -45 -43 -45 
-45 -43 -45 -45 -43 -45 -43 -45 -43 -45 
-43 -45 -43 -45 -43 -45 -45 -45 -43 -41 
-43 -45 -43 -45 -43 -45 -43 -45 -43 -41 
-45 -45 -43 -45 -43 -45 -43 -45 -43 -45 
-45 -45 -43 -45 -43 -45 -43 -45 -45 -45 
-45 -45 -45 -45 -45 -45 -43 -45 -45 -45 
-43 -45 -43 -45 -45 -43 -45 -45 -43 -45 
-43 -43 -89 -45 -43 -45 -45 -45 -45 -45 
-43 -45 -43 -45 -45 -43 -43 -91 -43 -45 
-45 -43 -45 -43 -45 -43 -43 -45 -45 -43 
-43 -45 -45 -45 -45 -43 -45 -45 -45 -43 
-45 -43 -43 -45 -45 -45 -91 -43 -43 -43 
-43 -43 -45 -45 -53 -53 -45 -43 -43 -43 
-43 -45 -43 -41 -43 -45 -43 -45 -45 -45 
-43 -45 -43 -45 -45 -45 -45 -45 -45 -43 
-43 -45 -45 -43 -45 -43 -43 -45 -45 -43 
-45 -45 -43 -45 -43 -43 -45 -43 -45 -43 
-45 -45 -43 -43 -43 -43 -45 -43 -43 -43 
-43 -43 -45 -43 -45 -43 -43 -45 -43 -43 
-43 -43 -45 -43 -43 -45 -45 -45 -45 -45 
-43 -45 -43 -45 -43 -43 -45 -43 -43 -45 
-55 -47 -43 -45 -43 -43 -45 -45 -43 -43 
-45 -47 -47 -45 -45 -45 -45 -43 -45 -45 
-43 -43 -45 -45 -83 -45 -45 -45 -43 -45 
-45 -45 -45 -47 -43 -45 -43 -47 -45 -43 
-47 -45 -45 -43 -43 -45 -43 -43 -43 -45 
-45 -47 -45 -47 -45 -47 -47 -45 -47 -45 
-45 -47 -45 -45 -45 -47 -45 -45 -47 -45 
-49 -47 -45 -47 -43 -45 -45 -45 -43 -45 
-45 -45 -47 -45 -47 -45 -47 -47 -45 -45 
-45 -47 -45 -45 -45 -45 -43 -45 -51 -51 
-51 -45 -45 -45 -45 -45 -45 -51 -45 -45 
-45 -45 -45 -43 -45 -47 -45 -47 -45 -45 
-45 -45 -45 -45 -45 -45 -47 -45 -43 -45 
-43 -43 -45 -45 -45 -47 -45 -45 -43 -45 
-43 -45 -45 -45 -45 -45 -45 -45 -43 -45 
-43 -45 -43 -45 -45 -45 -45 -47 -45 -47 
-45 -49 -47 -47 -47 -47 -45 -89 -45 -47 
-47 -43 -41 -41 -41 -43 -49 -43 -45 -47 
-45 -45 -47 -45 -49 -49 -47 -45 -45 -47 
-47 -45 -45 -45 -47 -45 -45 -43 -45 -45 
-45 -45 -47 -45 -45 -43 -45 -43 -45 -45 
-43 -43 -45 -45 -43 -43 -45 -45 -45 -45 
-51 -49 -47 -43 -45 -43 -45 -45 -45 -45 
-43 -43 -45 -43 -43 -45 -45 -45 -47 -45 
-45 -43 -45 -45 -43 -45 -45 -43 -43 -45 
-43 -45 -43 -45 -43 -45 -43 -45 -45 -43 
-45 -45 -45 -45 -45 -45 -45 -45 -45 -45 
-45 -45 -45 -43 -45 -43 -45 -43 -45 -43 
-45 -43 -45 -45 -43 -43 -45 -71 -45 -43 
-45 -43 -45 -43 -45 -45 -43 -45 -43 -45 
-43 -87 -43 -45 -43 -43 -43 -45 -45 -45 
-45 -45 -45 -45 -45 -45 -43 -45 -43 -45 
-43 -45 -43 -45 -43 -45 -45 -43 -45 -43 
-45 -45 -45 -43 -45 -45 -45 -45 -45 -43 
-45 -45 -45 -43 -45 -43 -45 -43 -45 -43 
-45 -43 -45 -43 -43 -43 -45 -43 -45 -43 
-45 -45 -45 -43 -43 -43 -43 -43 -43 -89 
-45 -43 -45 -45 -45 -43 -45 -45 -45 -45 
-43 -45 -43 -45 -45 -45 -45 -45 -45 -43 
-47 -45 -45 -43 -45 -45 -45 -45 -45 -43 
-45 -45 -45 -45 -81 -45 -45 -45 -43 -45 
-43 -45 -43 -45 -45 -45 -43 -45 -45 -45 
-45 -45 -43 -45 -45 -45 -45 -45 -43 -45 
-45 -45 -45 -45 -87 -45 -43 -45 -43 -45 
-45 -45 -43 -45 -45 -45 -45 -45 -43 -45 
-45 -45 -45 -43 -91 -45 -45 -45 -45 -43 
-45 -45 -45 -45 -45 -45 -45 -43 -45 -45 
-45 -45 -45 -43 -45 -45 -45 -45 -45 -43 
-45 -43 -45 -45 -45 -45 -45 -43 -45 -45 
-45 -43 -45 -43 -43 -45 -43 -45 -45 -45 
-45 -45 -43 -45 -43 -45 -45 -43 -45 -43 
-45 -43 -45 -45 -45 -43 -45 -45 -45 -43 
-45 -45 -45 -45 -43 -45 -45 -45 -43 -43 
-45 -43 -45 -45 -43 -43 -43 -43 -43 -45 
-45 -43 -45 -43 -45 -43 -45 -43 -43 -43 
-45 -43 -45 -43 -45 -45 -45 -43 -43 -45 
-43 -43 -43 -45 -43 -43 -43 -43 -45 -45 
-45 -43 -45 -43 -43 -43 -45 -43 -45 -43 
-45 -43 -45 -43 -45 -45 -43 -45 -43 -47 
-45 -45 -43 -43 -43 -45 -43 -45 -43 -45 
-45 -45 -45 -45 -45 -43 -45 -43 -47 -83 
-45 -91 -47 -45 -45 -43 -87 -45 -45 -45 
-43 -45 -43 -47 -47 -45 -45 -45 -43 -43 
-43 -45 -45 -47 -49 -51 -45 -43 -43 -43 
-43 -43 -45 -43 -45 -43 -45 -43 -45 -43 
-45 -45 -45 -45 -43 -45 -47 -45 -45 -43 
-45 -45 -45 -45 -45 -43 -45 -45 -45 -45 
-47 -45 -47 -45 -45 -43 -45 -91 -45 -43 
-43 -45 -43 -43 -43 -43 -45 -43 -45 -43 
-45 -43 -43 -45 -43 -45 -43 -43 -43 -45 
-43 -43 -43 -45 -45 -43 -45 -43 -43 -43 
-65 -43 -45 -43 -45 -43 -43 -43 -43 -45 
-43 -45 -43 -45 -43 -43 -43 -39 -43 -45 
-43 -43 -43 -43 -43 -43 -43 -43 -43 -43 
-43 -43 -43 -43 -43 -45 -45 -43 -43 -43 
-43 -43 -43 -43 -43 -43 -43 -91 -43 -43 
-43 -43 -43 -45 -41 -45 -45 -43 -43 -43 
-43 -43 -45 -43 -45 -43 -43 -43 -43 -45 
-43 -43 -43 -43 -43 -45 -41 -43 -43 -45 
-43 -43 -43 -43 -43 -43 -43 -43 -45 -43 
-43 -43 -43 -43 -43 -43 -45 -45 -45 -43 
-45 -43 -45 -43 -45 -43 -47 -45 -45 -43 
-43 -43 -45 -43 -45 -43 -43 -43 -39 -45 
-43 -45 -45 -45 -45 -43 -47 -45 -47 -45 
-45 -45 -47 -45 -45 -47 -43 -45 -45 -47 
-45 -45 -45 -45 -55 -53 -47 -47 -45 -47 
-47 -43 -47 -43 -47 -45 -43 -45 -45 -47 
-47 -47 -43 -47 -45 -45 -45 -45 -45 -45 
-47 -43 -45 -43 -47 -45 -45 -43 -91 -47 
-45 -47 -45 -47 -45 -47 -43 -45 -45 -43 
-45 -43 -45 -43 -45 -45 -45 -45 -45 -45 
-47 -47 -47 -45 -47 -45 -47 -43 -45 -47 
-45 -45 -47 -47 -45 -45 -45 -47 -43 -45 
-45 -47 -43 -47 -47 -47 -47 -47 -47 -45 
-45 -45 -45 -45 -45 -45 -45 -45 -47 -45 
-45 -47 -47 -45 -45 -45 -43 -45 -45 -43 
-43 -45 -43 -45 -45 -47 -47 -47 -47 -45 
-45 -45 -45 -43 -45 -45 -47 -45 -49 -47 
-47 -45 -45 -45 -47 -47 -47 -47 -45 -47 
-47 -43 -43 -43 -45 -43 -43 -41 -45 -43 
-47 -45 -45 -47 -43 -45 -47 -45 -47 -43 
-45 -47 -47 -47 -71 -43 -43 -43 -41 -43 
-87 -45 -43 -45 -43 -45 -45 -45 -45 -45 
-45 -45 -45 -45 -45 -47 -47 -45 -45 -45 
-45 -45 -47 -45 -45 -47 -47 -45 -45 -45 
-45 -45 -45 -45 -47 -45 -45 -45 -45 -45 
-45 -45 -43 -45 -45 -45 -45 -43 -45 -47 
-45 -45 -43 -45 -45 -45 -45 -47 -43 -43 
-45 -41 -45 -45 -43 -45 -43 -43 -45 -43 
-45 -45 -45 -43 -45 -43 -45 -45 -45 -43 
-45 -45 -45 -43 -45 -45 -45 -45 -43 -45 
-45 -45 -45 -43 -45 -45 -43 -45 -43 -43 
-45 -45 -45 -45 -43 -45 -43 -45 -45 -45 
-43 -45 -43 -45 -43 -45 -45 -45 -45 -45 
-45 -45 -45 -45 -45 -45 -45 -43 -45 -43 
-45 -43 -45 -43 -43 -43 -47 -45 -45 -45 
-43 -45 -43 -47 -45 -45 -43 -45 -45 -45 
-43 -45 -43 -45 -45 -45 -43 -45 -43 -45 
-45 -45 -43 -45 -43 -45 -43 -45 -43 -45 
-45 -45 -43 -43 -45 -43 -45 -43 -45 -43 
-43 -43 -45 -43 -45 -43 -45 -45 -45 -43 
-45 -43 -45 -43 -45 -43 -45 -45 -43 -45 
-43 -45 -45 -45 -43 -43 -45 -43 -45 -43 
-45 -45 -45 -43 -45 -43 -45 -45 -45 -45 
-43 -45 -45 -45 -45 -45 -45 -45 -45 -43 
-55 -45 -43 -45 -45 -43 -45 -43 -45 -43 
-45 -45 -43 -43 -45 -43 -45 -43 -45 -45 
-45 -45 -41 -43 -45 -43 -91 -43 -45 -43 
-45 -43 -45 -43 -45 -45 -43 -45 -45 -45 
-45 -45 -43 -45 -45 -45 -43 -45 -43 -45 
-45 -45 -45 -45 -45 -45 -45 -45 -43 -45 
-45 -45 -43 -45 -43 -45 -43 -45 -43 -45 
-43 -45 -45 -45 -45 -45 -43 -45 -43 -45 
-45 -45 -45 -45 -45 -45 -45 -55 -45 -43 
-45 -43 -45 -43 -45 -45 -45 -43 -45 -43 
-45 -45 -43 -45 -45 -45 -45 -45 -45 -43 
-45 -43 -45 -43 -45 -43 -45 -43 -45 -45 
-43 -45 -43 -45 -45 -45 -45 -45 -43 -45 
-45 -45 -45 -45 -45 -45 -45 -45 -45 -43 
-45 -43 -45 -45 -45 -43 -89 -43 -45 -45 
-45 -43 -45 -45 -45 -43 -45 -43 -45 -45 
-45 -45 -45 -43 -45 -45 -45 -43 -45 -43 
-45 -45 -45 -45 -45 -43 -45 -43 -45 -43 
-45 -45 -43 -45 -45 -45 -45 -45 -45 -45 
-43 -45 -43 -45 -45 -43 -45 -43 -45 -45 
-89 -89 -45 -43 -45 -45 -45 -43 -45 -43 
-45 -43 -43 -45 -45 -45 -45 -43 -45 -43 
-45 -45 -45 -45 -45 -43 -45 -43 -45 -45 
-45 -43 -45 -43 -45 -43 -45 -45 -43 -45 
-45 -45 -43 -45 -45 -45 -43 -45 -43 -45 
-43 -45 -45 -45 -45 -43 -45 -45 -45 -45 
-43 -45 -43 -45 -43 -45 -45 -45 -45 -45 
-45 -43 -45 -45 -45 -43 -45 -43 -45 -43 
-43 -45 -45 -45 -43 -45 -45 -45 -43 -45 
-43 -45 -43 -45 -43 -45 -45 -45 -45 -45 
-45 -45 -45 -45 -45 -45 -43 -45 -43 -45 
-43 -45 -45 -45 -43 -45 -45 -45 -45 -45 
-45 -45 -45 -45 -45 -43 -43 -43 -45 -45 
-45 -45 -45 -45 -45 -45 -45 -45 -45 -45 
-43 -45 -43 -45 -45 -43 -45 -43 -45 -45 
-45 -43 -45 -45 -87 -43 -45 -43 -45 -41 
-45 -45 -43 -45 -45 -49 -47 -45 -45 -45 
-45 -45 -45 -45 -43 -45 -45 -45 -45 -45 
-45 -43 -45 -43 -45 -43 -45 -43 -45 -45 
-45 -45 -45 -45 -45 -43 -45 -45 -45 -45 
-45 -43 -45 -43 -45 -43 -45 -45 -45 -43 
-45 -45 -45 -43 -91 -43 -45 -45 -45 -45 
-45 -45 -45 -45 -45 -45 -45 -43 -45 -45 
-45 -43 -45 -45 -45 -43 -45 -43 -45 -43 
-45 -43 -43 -45 -45 -45 -43 -45 -45 -45 
-45 -45 -43 -45 -43 -45 -45 -45 -45 -45 
-43 -45 -45 -45 -45 -45 -45 -45 -45 -45 
-43 -45 -45 -45 -45 -45 -45 -45 -83 -45 
-43 -45 -43 -45 -45 -45 -43 -45 -45 -45 
-45 -45 -43 -45 -45 -45 -45 -45 -45 -43 
-45 -45 -45 -45 -45 -45 -45 -43 -45 -45 
-45 -43 -45 -45 -45 -45 -45 -45 -43 -45 
-45 -45 -45 -45 -43 -45 -43 -45 -45 -45 
-45 -45 -45 -45 -43 -45 -43 -45 -43 -45 
-43 -45 -45 -43 -45 -45 -45 -45 -45 -43 
-87 -87 -45 -43 -45 -45 -45 -43 -45 -45 
-45 -45 -45 -43 -45 -43 -45 -45 -43 -45 
-43 -45 -45 -45 -43 -45 -45 -55 -45 -43 
-45 -45 -45 -45 -45 -45 -43 -45 -45 -45 
-43 -45 -45 -45 -45 -43 -45 -43 -45 -39 
-45 -43 -45 -43 -45 -45 -45 -43 -45 -45 
-45 -45 -45 -43 -45 -45 -45 -45 -43 -45 
-43 -45 -43 -43 -45 -43 -45 -45 -45 -45 
-45 -45 -45 -45 -45 -45 -45 -45 -45 -43 
-45 -43 -45 -45 -91 -45 -43 -45 -43 -45 
-43 -45 -45 -45 -43 -45 -45 -45 -43 -45 
-45 -45 -43 -45 -45 -45 -45 -45 -45 -45 
-45 -45 -45 -43 -45 -45 -45 -45 -45 -45 
-45 -43 -45 -43 -45 -43 -45 -45 -45 -45 
-45 -43 -45 -45 -43 -45 -43 -45 -43 -45 
-43 -45 -43 -45 -43 -45 -43 -45 -45 -45 
-43 -45 -45 -45 -45 -45 -45 -43 -45 -43 
-45 -43 -45 -45 -45 -45 -45 -45 -45 -45 
-45 -45 -45 -43 -45 -45 -45 -45 -45 -45 
-45 -43 -45 -43 -45 -45 -45 -43 -45 -43 
-45 -45 -45 -43 -45 -43 -45 -45 -45 -43 
-45 -45 -45 -43 -45 -43 -45 -45 -45 -91 
-91 -45 -43 -45 -43 -45 -45 -45 -45 -45 
-45 -45 -45 -45 -45 -43 -45 -45 -45 -45 
-45 -43 -45 -45 -45 -43 -45 -43 -45 -43 
-45 -43 -45 -43 -45 -43 -45 -45 -45 -43 
-45 -45 -45 -45 -45 -43 -45 -45 -45 -43 
-45 -43 -45 -43 -45 -45 -45 -45 -43 -45 
-45 -45 -43 -45 -45 -45 -43 -43 -43 -43 
-45 -45 -45 -43 -45 -45 -43 -45 -45 -45 
-45 -45 -43 -43 -43 -45 -45 -45 -43 -45 
-45 -91 -45 -43 -43 -43 -45 -43 -43 -45 
-43 -45 -43 -45 -45 -45 -45 -45 -45 -47 
-45 -45 -47 -43 -47 -43 -45 -45 -45 -45 
-43 -43 -45 -43 -43 -43 -43 -45 -45 -45 
-45 -47 -45 -47 -45 -45 -43 -45 -43 -47 
-43 -45 -45 -45 -45 -45 -45 -47 -43 -47 
-43 -47 -45 -45 -47 -47 -45 -47 -47 -55 
