-59 -57 -59 -59 -59 -57 -59 -59 -59 -57 
-59 -59 -59 -57 -59 -57 -59 -59 -59 -57 
-59 -59 -59 -59 -59 -59 -59 -57 -59 -59 
-59 -57 -59 -57 -59 -59 -59 -59 -59 -57 
-57 -57 -55 -57 -57 -57 -57 -57 -55 -57 
-57 -57 -57 -57 -57 -55 -57 -55 -55 -55 
-57 -57 -57 -57 -57 -57 -57 -57 -57 -57 
-57 -57 -57 -57 -57 -55 -57 -57 -57 -57 
-55 -57 -61 -59 -59 -57 -59 -59 -61 -59 
-59 -59 -59 -59 -59 -59 -61 -61 -59 -61 
-61 -61 -63 -63 -61 -63 -61 -61 -63 -63 
-61 -65 -61 -59 -61 -59 -59 -57 -57 -57 
-55 -59 -57 -57 -55 -57 -59 -59 -59 -57 
-57 -55 -61 -63 -61 -63 -57 -57 -59 -55 
-61 -59 -59 -57 -55 -55 -57 -57 -57 -55 
-55 -57 -57 -57 -57 -57 -55 -57 -55 -59 
-59 -57 -59 -59 -59 -61 -63 -59 -59 -61 
-63 -63 -65 -63 -65 -63 -65 -61 -61 -61 
-61 -61 -61 -61 -61 -61 -61 -63 -61 -61 
-59 -59 -59 -59 -59 -57 -57 -59 -59 -59 
-57 -57 -57 -59 -61 -61 -61 -63 -59 -63 
-63 -63 -63 -63 -65 -61 -59 -59 -59 -59 
-59 -61 -63 -63 -61 -61 -61 -61 -61 -61 
-61 -61 -59 -57 -59 -57 -57 -57 -59 -59 
-57 -57 -59 -57 -59 -57 -57 -59 -61 -59 
-57 -57 -59 -57 -57 -61 -59 -61 -59 -61 
-59 -61 -61 -59 -59 -57 -57 -57 -59 -57 
-61 -61 -57 -59 -59 -57 -57 -55 -57 -57 
-57 -57 -57 -57 -59 -59 -59 -59 -61 -61 
-61 -61 -59 -59 -59 -59 -57 -59 -63 -61 
-63 -63 -59 -61 -57 -57 -57 -57 -59 -59 
-59 -61 -59 -59 -59 -59 -59 -61 -59 -59 
-61 -59 -57 -59 -59 -59 -59 -57 -57 -59 
-59 -59 -59 -59 -61 -59 -61 -61 -57 -59 
-59 -59 -59 -59 -59 -57 -61 -59 -61 -59 
-59 -59 -61 -61 -59 -59 -59 -59 -59 -59 
-61 -61 -61 -57 -59 -61 -59 -59 -59 -59 
-61 -61 -61 -61 -59 -59 -59 -61 -59 -59 
-59 -59 -57 -61 -59 -59 -59 -57 -59 -57 
-61 -59 -59 -61 -59 -61 -57 -59 -59 -59 
-59 -59 -59 -59 -59 -59 -61 -61 -61 -61 
-59 -61 -61 -61 -61 -59 -61 -59 -59 -59 
-59 -61 -59 -59 -91 -61 -61 -59 -59 -59 
-61 -59 -59 -59 -59 -61 -59 -59 -57 -59 
-59 -59 -59 -59 -59 -59 -59 -59 -59 -59 
-57 -59 -57 -57 -59 -59 -57 -57 -57 -61 
-59 -61 -61 -61 -59 -59 -61 -61 -59 -59 
-59 -59 -59 -59 -57 -61 -59 -61 -59 -61 
-61 -59 -61 -59 -57 -59 -59 -59 -61 -59 
-59 -61 -61 -59 -61 -59 -61 -61 -59 -59 
-59 -61 -59 -61 -57 -61 -57 -57 -59 -59 
-59 -59 -59 -61 -59 -59 -59 -61 -59 -59 
-61 -61 -59 -59 -59 -59 -61 -57 -59 -59 
-59 -59 -59 -61 -59 -59 -59 -59 -59 -59 
-87 -59 -61 -59 -59 -59 -63 -61 -61 -59 
-61 -59 -59 -59 -59 -59 -61 -59 -59 -59 
-59 -59 -59 -59 -59 -59 -59 -59 -57 -59 
-59 -59 -57 -57 -59 -57 -57 -59 -57 -57 
-57 -57 -59 -59 -57 -61 -61 -61 -61 -61 
-61 -63 -89 -59 -59 -61 -63 -61 -65 -59 
-59 -61 -61 -61 -61 -61 -61 -57 -65 -65 
-65 -65 -89 -61 -61 -61 -63 -63 -65 -61 
-61 -59 -57 -59 -59 -61 -63 -55 -55 -59 
-57 -57 -63 -59 -61 -61 -57 -55 -61 -59 
-57 -59 -57 -57 -57 -57 -57 -57 -59 -55 
-55 -59 -59 -61 -61 -59 -59 -59 -61 -63 
-61 -57 -55 -57 -57 -61 -61 -59 -59 -57 
-59 -59 -63 -61 -59 -59 -67 -61 -63 -59 
-61 -61 -63 -61 -63 -61 -63 -61 -63 -61 
-61 -61 -61 -63 -61 -59 -61 -65 -65 -65 
-65 -61 -61 -59 -59 -59 -59 -55 -59 -59 
-57 -57 -57 -55 -57 -57 -57 -57 -59 -59 
-57 -57 -55 -57 -55 -59 -57 -59 -55 -61 
-59 -59 -59 -57 -57 -57 -59 -59 -59 -59 
-59 -57 -59 -59 -61 -63 -59 -61 -57 -59 
-59 -61 -59 -59 -59 -59 -61 -61 -61 -59 
-61 -57 -61 -61 -59 -59 -61 -59 -61 -61 
-61 -61 -61 -59 -61 -59 -61 -59 -61 -59 
-61 -59 -57 -57 -59 -59 -59 -59 -59 -59 
-57 -59 -57 -57 -57 -57 -59 -59 -59 -57 
-59 -59 -57 -57 -55 -57 -57 -59 -57 -59 
-59 -59 -61 -61 -63 -63 -61 -63 -61 -63 
-63 -63 -63 -65 -65 -65 -67 -63 -63 -65 
-61 -63 -57 -57 -59 -59 -59 -63 -61 -59 
-61 -61 -61 -59 -59 -59 -59 -59 -59 -59 
-59 -59 -59 -57 -57 -59 -61 -63 -59 -61 
-57 -55 -57 -57 -91 -57 -57 -61 -59 -61 
-57 -57 -59 -59 -59 -59 -61 -61 -63 -61 
-59 -61 -59 -59 -59 -57 -59 -57 -57 -55 
-55 -59 -59 -59 -61 -63 -61 -61 -59 -57 
-61 -61 -63 -63 -63 -65 -63 -61 -65 -63 
-65 -63 -65 -63 -63 -59 -61 -59 -61 -57 
-57 -59 -55 -57 -55 -57 -57 -59 -57 -59 
-57 -57 -57 -57 -59 -59 -59 -59 -57 -61 
-57 -59 -59 -57 -57 -59 -61 -59 -59 -61 
-59 -59 -61 -61 -59 -59 -61 -59 -59 -59 
-61 -61 -61 -59 -61 -61 -61 -59 -59 -61 
-59 -59 -59 -59 -59 -59 -61 -59 -61 -59 
-57 -59 -61 -59 -59 -59 -61 -59 -59 -59 
-59 -59 -59 -59 -61 -59 -57 -59 -57 -59 
-61 -59 -59 -59 -59 -59 -59 -59 -59 -57 
-59 -61 -59 -59 -59 -59 -59 -61 -59 -57 
-57 -59 -59 -59 -61 -59 -61 -59 -59 -57 
-59 -59 -61 -61 -61 -61 -61 -59 -57 -59 
-59 -59 -59 -61 -59 -59 -59 -59 -59 -59 
-59 -59 -59 -61 -59 -59 -59 -59 -57 -57 
-59 -59 -59 -59 -59 -59 -59 -59 -61 -59 
-59 -59 -61 -59 -61 -59 -59 -61 -59 -59 
-59 -59 -59 -59 -59 -59 -59 -59 -57 -57 
-59 -57 -59 -59 -59 -57 -59 -57 -59 -59 
-59 -59 -61 -59 -57 -59 -59 -59 -61 -61 
-61 -61 -61 -61 -61 -59 -61 -61 -61 -59 
-59 -61 -59 -59 -59 -61 -61 -59 -59 -61 
-61 -61 -61 -61 -61 -59 -59 -59 -61 -61 
-59 -61 -61 -59 -59 -59 -59 -59 -59 -59 
-61 -59 -59 -61 -61 -59 -59 -59 -59 -61 
-61 -61 -59 -91 -59 -59 -59 -59 -59 -59 
-59 -59 -59 -59 -61 -57 -57 -61 -59 -59 
-59 -61 -59 -59 -59 -59 -57 -55 -57 -59 
-59 -57 -61 -61 -61 -61 -57 -59 -59 -59 
-61 -59 -59 -55 -59 -57 -59 -59 -61 -61 
-59 -59 -61 -61 -57 -59 -61 -59 -59 -61 
-59 -59 -59 -59 -57 -57 -57 -57 -59 -57 
-57 -57 -57 -55 -55 -55 -57 -57 -59 -59 
-59 -59 -61 -61 -59 -63 -65 -61 -61 -61 
-61 -61 -61 -55 -57 -53 -59 -61 -61 -59 
-57 -59 -59 -61 -59 -61 -63 -63 -69 -71 
-63 -63 -67 -67 -65 -67 -63 -63 -59 -57 
-61 -61 -61 -63 -63 -63 -65 -65 -65 -67 
-57 -59 -63 -65 -61 -59 -57 -59 -59 -63 
-61 -61 -61 -63 -61 -65 -61 -59 -57 -59 
-57 -59 -57 -57 -57 -57 -57 -59 -59 -57 
-57 -55 -57 -55 -57 -55 -55 -57 -57 -59 
-57 -59 -59 -59 -59 -57 -59 -83 -57 -63 
-67 -67 -71 -67 -73 -69 -65 -67 -65 -65 
-65 -67 -63 -67 -63 -65 -63 -65 -63 -65 
-65 -63 -63 -63 -63 -63 -65 -63 -63 -63 
-65 -63 -65 -63 -65 -63 -63 -63 -63 -65 
-67 -57 -59 -59 -67 -65 -67 -69 -67 -67 
-65 -67 -69 -69 -73 -69 -69 -73 -69 -69 
-67 -69 -67 -69 -67 -67 -69 -67 -67 -67 
-69 -67 -65 -67 -65 -67 -67 -65 -69 -65 
-65 -67 -65 -65 -65 -61 -63 -61 -61 -61 
-61 -57 -57 -57 -61 -59 -59 -61 -59 -59 
-61 -61 -59 -59 -59 -59 -61 -61 -57 -57 
-57 -59 -59 -57 -57 -57 -57 -59 -59 -55 
-57 -55 -55 -57 -55 -55 -57 -55 -55 -55 
-57 -53 -57 -57 -59 -59 -61 -61 -65 -63 
-65 -61 -61 -61 -61 -63 -61 -61 -61 -61 
-61 -63 -63 -61 -61 -91 -59 -59 -59 -57 
-57 -57 -61 -61 -59 -61 -61 -63 -91 -65 
-59 -61 -91 -61 -63 -65 -63 -63 -63 -63 
-63 -63 -61 -63 -63 -61 -63 -63 -63 -59 
-61 -59 -61 -59 -59 -59 -59 -61 -59 -59 
-59 -59 -57 -57 -59 -59 -59 -57 -59 -57 
-59 -59 -57 -59 -61 -61 -59 -61 -59 -59 
-59 -61 -61 -61 -63 -65 -63 -65 -65 -65 
-61 -59 -61 -61 -59 -57 -59 -59 -59 -59 
-59 -57 -57 -59 -57 -59 -61 -59 -59 -59 
-59 -59 -61 -61 -63 -61 -61 -61 -59 -61 
-63 -63 -63 -63 -65 -63 -67 -63 -65 -65 
-61 -63 -63 -63 -61 -63 -59 -59 -59 -59 
-59 -59 -59 -57 -57 -59 -59 -59 -55 -59 
-57 -57 -59 -57 -59 -57 -59 -59 -61 -59 
-59 -59 -59 -57 -57 -55 -59 -57 -57 -59 
-59 -61 -61 -61 -61 -59 -59 -57 -55 -57 
-57 -59 -57 -59 -59 -59 -59 -61 -59 -59 
-61 -59 -59 -59 -59 -61 -59 -61 -59 -59 
-59 -57 -57 -59 -59 -59 -59 -57 -59 -59 
-57 -59 -57 -57 -89 -59 -59 -57 -59 -59 
-59 -57 -59 -57 -59 -57 -59 -57 -59 -57 
-59 -59 -57 -59 -57 -57 -57 -57 -59 -57 
-57 -57 -57 -57 -57 -57 -57 -55 -57 -57 
-55 -57 -57 -55 -59 -57 -57 -59 -57 -57 
-57 -57 -59 -57 -57 -57 -57 -55 -55 -57 
-57 -57 -57 -59 -61 -61 -61 -61 -61 -61 
-91 -59 -57 -59 -59 -57 -57 -55 -59 -57 
-59 -55 -57 -59 -57 -59 -59 -59 -61 -59 
-91 -59 -59 -59 -59 -57 -57 -61 -59 -59 
-61 -63 -59 -61 -61 -61 -61 -61 -61 -63 
-59 -57 -61 -63 -61 -63 -61 -59 -61 -57 
-59 -57 -57 -57 -61 -59 -61 -61 -61 -59 
-61 -59 -59 -57 -59 -87 -59 -59 -59 -59 
-57 -59 -59 -59 -59 -63 -61 -59 -61 -63 
-63 -63 -65 -65 -63 -63 -63 -63 -59 -61 
-59 -59 -59 -57 -57 -59 -59 -59 -59 -59 
-59 -59 -59 -59 -59 -59 -59 -57 -61 -61 
-63 -65 -63 -65 -61 -61 -61 -61 -61 -57 
-59 -59 -59 -61 -87 -61 -61 -61 -61 -65 
-63 -61 -61 -63 -63 -65 -63 -65 -63 -61 
-63 -59 -59 -59 -59 -59 -61 -61 -59 -61 
-85 -61 -61 -61 -61 -61 -63 -61 -61 -59 
-61 -61 -61 -61 -63 -61 -63 -61 -63 -61 
-61 -59 -61 -63 -61 -63 -61 -63 -65 -63 
-65 -63 -59 -57 -59 -59 -59 -61 -59 -59 
-59 -59 -59 -59 -59 -57 -57 -59 -57 -63 
-63 -61 -63 -63 -61 -63 -63 -61 -61 -63 
-61 -61 -59 -59 -57 -57 -59 -59 -55 -57 
-55 -57 -57 -57 -55 -57 -55 -55 -57 -57 
-57 -55 -57 -55 -57 -57 -57 -53 -57 -55 
-57 -59 -57 -57 -57 -57 -61 -61 -59 -59 
-57 -57 -57 -57 -57 -59 -59 -59 -59 -59 
-57 -59 -59 -59 -59 -59 -61 -59 -57 -59 
-59 -61 -59 -59 -59 -59 -59 -59 -57 -59 
-57 -59 -57 -57 -57 -59 -57 -57 -55 -59 
-61 -61 -61 -59 -57 -59 -57 -59 -61 -61 
-59 -61 -59 -61 -61 -59 -59 -57 -57 -59 
-59 -59 -61 -59 -59 -55 -61 -61 -65 -65 
-65 -67 -65 -67 -65 -65 -59 -61 -61 -61 
-61 -61 -63 -63 -61 -63 -59 -61 -63 -63 
-65 -61 -65 -61 -61 -59 -57 -59 -61 -59 
-59 -59 -57 -61 -63 -63 -63 -61 -61 -57 
-57 -55 -59 -61 -63 -57 -55 -59 -61 -61 
-65 -59 -61 -59 -61 -63 -59 -59 -59 -59 
-63 -63 -63 -63 -63 -63 -65 -65 -63 -63 
-61 -63 -59 -61 -61 -61 -59 -59 -61 -63 
-59 -59 -61 -61 -63 -63 -67 -65 -63 -63 
-65 -63 -63 -63 -61 -61 -61 -61 -61 -59 
-61 -61 -61 -61 -61 -61 -61 -59 -61 -59 
-57 -61 -59 -59 -59 -59 -59 -61 -59 -61 
-61 -63 -59 -59 -61 -59 -61 -59 -61 -61 
-61 -57 -59 -61 -61 -89 -61 -61 -61 -63 
-61 -63 -61 -61 -61 -63 -63 -61 -61 -57 
-59 -61 -59 -59 -61 -61 -59 -61 -59 -61 
-59 -63 -61 -61 -61 -59 -59 -61 -63 -61 
-63 -61 -61 -61 -59 -61 -61 -61 -59 -61 
-59 -59 -59 -61 -63 -57 -59 -61 -61 -59 
-61 -61 -59 -61 -59 -59 -59 -59 -61 -61 
-61 -61 -59 -61 -61 -61 -61 -61 -59 -61 
-63 -59 -59 -61 -59 -59 -61 -59 -59 -61 
-59 -61 -61 -61 -61 -61 -61 -61 -61 -61 
-59 -61 -61 -61 -61 -61 -59 -61 -61 -61 
-63 -61 -61 -61 -59 -91 -59 -61 -61 -61 
-61 -61 -61 -61 -61 -61 -61 -61 -61 -61 
-63 -59 -61 -59 -61 -59 -61 -61 -59 -61 
-61 -65 -65 -61 -61 -63 -61 -61 -61 -59 
-59 -61 -61 -59 -59 -59 -59 -59 -59 -59 
-61 -61 -61 -59 -57 -59 -57 -59 -59 -59 
-59 -59 -57 -59 -61 -59 -61 -59 -59 -57 
-59 -57 -57 -59 -59 -59 -59 -59 -61 -59 
-61 -59 -61 -59 -61 -63 -61 -59 -61 -61 
-59 -59 -65 -61 -59 -59 -59 -61 -63 -67 
-67 -59 -59 -61 -61 -65 -67 -65 -65 -61 
-61 -61 -63 -61 -61 -61 -61 -59 -59 -57 
-59 -61 -61 -61 -61 -59 -57 -59 -59 -61 
-59 -61 -59 -59 -61 -63 -63 -61 -61 -61 
-61 -61 -61 -61 -61 -63 -61 -61 -61 -61 
-63 -63 -63 -63 -65 -63 -63 -65 -67 -65 
-65 -63 -61 -61 -91 -63 -63 -61 -61 -61 
-63 -61 -63 -61 -61 -61 -63 -61 -63 -63 
-63 -59 -61 -59 -57 -59 -59 -59 -59 -57 
-59 -59 -59 -59 -57 -59 -59 -57 -57 -91 
-55 -55 -57 -57 -59 -59 -89 -57 -55 -57 
-57 -57 -59 -61 -63 -67 -69 -71 -71 -71 
-71 -73 -71 -73 -69 -73 -71 -71 -69 -71 
-69 -71 -73 -71 -71 -71 -71 -71 -71 -71 
-71 -69 -71 -89 -71 -69 -69 -73 -71 -71 
-69 -71 -71 -73 -69 -69 -71 -71 -71 -73 
-69 -71 -71 -71 -71 -71 -71 -71 -69 -73 
-71 -57 -57 -59 -59 -57 -57 -57 -59 -57 
-59 -59 -57 -57 -57 -57 -57 -59 -59 -57 
-57 -59 -59 -59 -59 -57 -59 -59 -59 -59 
-59 -59 -59 -59 -57 -57 -57 -57 -57 -59 
-59 -57 -57 -57 -59 -59 -59 -59 -59 -59 
-59 -59 -59 -59 -59 -57 -59 -57 -55 -59 
-57 -57 -57 -59 -59 -61 -59 -59 -59 -59 
-59 -61 -59 -59 -61 -63 -61 -61 -59 -61 
-57 -57 -57 -57 -55 -57 -57 -57 -57 -59 
-59 -59 -59 -61 -63 -59 -61 -59 -59 -61 
-61 -59 -61 -57 -59 -57 -55 -57 -59 -57 
-59 -57 -59 -57 -59 -57 -57 -57 -59 -59 
-63 -63 -59 -59 -59 -59 -61 -61 -61 -61 
-63 -59 -61 -57 -55 -57 -55 -57 -55 -59 
-59 -63 -63 -63 -61 -61 -61 -61 -61 -63 
-61 -59 -57 -57 -59 -57 -57 -57 -57 -57 
-55 -59 -59 -59 -57 -57 -59 -59 -57 -57 
-57 -57 -57 -55 -59 -57 -57 -57 -57 -57 
-57 -59 -57 -59 -61 -59 -89 -57 -57 -57 
-59 -59 -59 -59 -59 -59 -59 -59 -61 -61 
-59 -63 -63 -63 -63 -63 -63 -59 -59 -61 
-63 -63 -65 -63 -65 -61 -63 -63 -61 -61 
-59 -57 -57 -57 -61 -59 -59 -61 -59 -61 
-55 -65 -61 -61 -59 -59 -57 -55 -57 -57 
-59 -59 -59 -57 -57 -57 -59 -57 -57 -57 
-57 -57 -61 -61 -57 -59 -59 -59 -59 -57 
-59 -57 -59 -59 -57 -59 -57 -57 -57 -59 
-57 -57 -57 -59 -57 -59 -59 -61 -61 -55 
-57 -59 -59 -61 -61 -59 -57 -61 -59 -59 
-59 -67 -59 -57 -59 -57 -57 -57 -57 -91 
-59 -57 -89 -59 -57 -57 -57 -55 -55 -57 
-57 -59 -55 -55 -55 -57 -55 -57 -57 -57 
-55 -59 -59 -57 -61 -63 -61 -61 -63 -63 
-63 -65 -67 -65 -65 -65 -67 -59 -57 -61 
-59 -57 -59 -57 -55 -57 -57 -57 -57 -59 
-59 -61 -59 -59 -59 -61 -61 -59 -59 -59 
-59 -57 -59 -61 -61 -59 -61 -59 -59 -59 
-59 -59 -57 -59 -59 -59 -59 -59 -61 -59 
-61 -61 -61 -61 -59 -61 -61 -57 -59 -59 
-59 -57 -59 -59 -59 -59 -59 -61 -61 -61 
-59 -59 -57 -57 -59 -57 -61 -63 -61 -59 
