-47 -49 -47 -49 -49 -49 -47 -49 -45 -47 
-49 -49 -47 -49 -49 -49 -49 -47 -49 -49 
-47 -49 -49 -47 -47 -49 -49 -49 -47 -91 
-49 -47 -49 -47 -49 -47 -49 -47 -49 -49 
-49 -47 -91 -49 -47 -49 -47 -49 -47 -49 
-47 -49 -47 -49 -47 -49 -47 -49 -49 -49 
-47 -49 -49 -47 -49 -47 -49 -47 -49 -49 
-49 -49 -49 -47 -49 -49 -49 -49 -49 -49 
-49 -47 -49 -47 -49 -47 -49 -47 -49 -47 
-49 -47 -49 -49 -49 -49 -47 -49 -47 -49 
-47 -49 -49 -49 -47 -49 -47 -45 -45 -49 
-47 -49 -47 -49 -47 -49 -47 -49 -49 -49 
-49 -49 -49 -49 -47 -49 -47 -51 -47 -49 
-47 -49 -49 -49 -47 -49 -47 -49 -49 -49 
-47 -49 -47 -49 -49 -49 -49 -49 -47 -49 
-47 -47 -49 -47 -49 -47 -49 -47 -49 -51 
-49 -47 -49 -47 -49 -47 -49 -47 -49 -91 
-91 -49 -49 -47 -49 -49 -49 -47 -49 -47 
-49 -47 -49 -49 -49 -49 -49 -49 -47 -49 
-49 -49 -49 -49 -47 -49 -47 -49 -47 -49 
-49 -49 -47 -49 -47 -49 -47 -49 -47 -49 
-47 -49 -49 -49 -47 -49 -49 -49 -47 -49 
-47 -49 -47 -49 -47 -49 -47 -49 -47 -47 
-85 -47 -49 -47 -91 -45 -49 -47 -49 -47 
-91 -49 -47 -49 -47 -49 -47 -49 -47 -49 
-47 -49 -47 -49 -47 -47 -49 -47 -49 -47 
-49 -47 -49 -49 -49 -49 -49 -47 -49 -49 
-49 -49 -49 -47 -49 -47 -49 -47 -49 -47 
-49 -47 -49 -47 -47 -49 -47 -47 -49 -47 
-49 -49 -49 -47 -47 -49 -47 -49 -47 -49 
-47 -49 -47 -49 -47 -49 -47 -49 -49 -49 
-47 -49 -47 -49 -49 -49 -47 -49 -49 -49 
-49 -49 -47 -49 -49 -49 -47 -49 -47 -49 
-47 -49 -47 -49 -47 -49 -49 -47 -49 -49 
-49 -47 -49 -49 -49 -47 -49 -45 -49 -47 
-49 -47 -49 -47 -49 -47 -49 -47 -49 -47 
-49 -47 -49 -47 -49 -47 -49 -49 -49 -49 
-49 -47 -49 -47 -49 -47 -49 -47 -49 -47 
-49 -49 -49 -47 -49 -47 -49 -47 -49 -47 
-49 -47 -45 -45 -47 -45 -47 -49 -49 -47 
-49 -47 -49 -47 -49 -47 -49 -49 -49 -47 
-49 -47 -49 -47 -49 -47 -49 -49 -49 -47 
-49 -47 -49 -47 -49 -47 -49 -49 -75 -49 
-47 -49 -49 -49 -49 -47 -49 -47 -49 -47 
-49 -49 -47 -49 -47 -49 -49 -49 -47 -47 
-49 -47 -49 -49 -49 -47 -49 -47 -49 -47 
-49 -49 -49 -47 -49 -47 -49 -47 -47 -49 
-47 -49 -47 -49 -47 -49 -47 -47 -49 -47 
-49 -49 -49 -49 -49 -47 -49 -47 -49 -47 
-49 -47 -49 -49 -49 -49 -49 -47 -49 -49 
-49 -49 -49 -47 -49 -47 -47 -49 -47 -49 
-47 -49 -49 -49 -47 -49 -47 -49 -47 -49 
-47 -49 -47 -47 -49 -47 -49 -47 -49 -47 
-49 -47 -49 -49 -49 -47 -49 -47 -49 -47 
-49 -47 -49 -47 -49 -47 -49 -47 -49 -47 
-49 -47 -49 -47 -49 -49 -49 -47 -49 -47 
-49 -47 -49 -49 -49 -47 -49 -49 -49 -47 
-49 -47 -49 -47 -49 -47 -49 -47 -49 -47 
-49 -47 -49 -49 -47 -49 -47 -49 -47 -49 
-47 -49 -47 -49 -47 -49 -47 -49 -47 -49 
-47 -49 -47 -47 -49 -47 -49 -37 -49 -47 
-49 -47 -49 -49 -49 -49 -47 -49 -49 -49 
-47 -49 -47 -49 -47 -49 -47 -49 -47 -49 
-47 -49 -47 -49 -49 -49 -49 -49 -47 -49 
-47 -49 -47 -49 -47 -49 -47 -49 -47 -49 
-47 -49 -47 -49 -49 -47 -49 -47 -49 -49 
-37 -49 -49 -49 -49 -49 -49 -49 -49 -49 
-47 -49 -47 -47 -49 -47 -49 -47 -49 -49 
-49 -47 -49 -47 -49 -49 -49 -47 -47 -49 
-47 -49 -49 -49 -49 -49 -49 -49 -49 -49 
-47 -49 -47 -49 -51 -89 -89 -49 -47 -49 
-49 -49 -47 -49 -47 -49 -47 -49 -49 -49 
-47 -49 -47 -49 -49 -49 -47 -49 -49 -49 
-47 -49 -49 -49 -47 -49 -49 -49 -47 -49 
-47 -51 -47 -49 -47 -49 -47 -49 -47 -49 
-47 -49 -49 -47 -49 -47 -49 -47 -49 -47 
-49 -47 -49 -49 -49 -47 -49 -47 -49 -49 
-49 -49 -49 -49 -49 -47 -49 -47 -47 -83 
-49 -49 -47 -47 -47 -49 -49 -49 -49 -49 
-49 -49 -49 -49 -53 -49 -49 -49 -49 -49 
-49 -49 -49 -49 -49 -49 -49 -49 -49 -49 
-49 -49 -49 -49 -49 -49 -49 -49 -49 -49 
-49 -47 -47 -47 -45 -45 -45 -47 -45 -47 
-45 -45 -47 -47 -47 -47 -47 -47 -45 -45 
-45 -47 -47 -47 -47 -47 -45 -47 -45 -45 
-47 -47 -45 -47 -47 -47 -47 -45 -47 -47 
-45 -47 -47 -47 -47 -47 -49 -47 -45 -45 
-45 -49 -51 -49 -49 -49 -47 -45 -45 -45 
-47 -47 -47 -45 -47 -45 -45 -47 -45 -47 
-45 -45 -47 -47 -47 -45 -47 -47 -47 -45 
-45 -45 -47 -47 -45 -45 -47 -47 -47 -45 
-47 -47 -47 -47 -47 -47 -45 -45 -47 -47 
-47 -47 -47 -47 -45 -47 -47 -45 -47 -47 
-47 -47 -47 -47 -47 -47 -45 -47 -47 -47 
-47 -47 -47 -45 -47 -45 -47 -47 -47 -47 
-47 -45 -47 -45 -47 -45 -47 -45 -47 -45 
-47 -45 -47 -45 -47 -47 -45 -47 -45 -47 
-47 -47 -49 -47 -45 -47 -45 -47 -47 -47 
-47 -45 -47 -47 -47 -47 -45 -45 -47 -45 
-47 -47 -47 -45 -45 -45 -47 -45 -47 -45 
-47 -45 -47 -45 -47 -45 -45 -45 -47 -47 
-45 -45 -47 -45 -45 -45 -47 -47 -47 -45 
-47 -45 -87 -45 -45 -47 -43 -49 -47 -49 
-47 -47 -47 -47 -47 -49 -47 -49 -47 -49 
-47 -49 -47 -49 -47 -49 -47 -51 -51 -47 
-51 -49 -49 -49 -51 -49 -51 -47 -49 -49 
-49 -49 -49 -47 -49 -49 -49 -49 -51 -49 
-49 -47 -49 -49 -49 -49 -49 -47 -49 -47 
-49 -47 -49 -49 -47 -49 -51 -49 -49 -49 
-51 -49 -51 -49 -49 -49 -49 -51 -47 -51 
-49 -51 -47 -49 -49 -49 -49 -49 -49 -51 
-49 -51 -49 -51 -49 -51 -49 -49 -51 -49 
-49 -49 -49 -49 -49 -47 -51 -49 -51 -49 
-49 -47 -49 -49 -47 -47 -47 -47 -47 -45 
-47 -47 -47 -47 -45 -47 -47 -47 -49 -91 
-43 -47 -45 -47 -47 -47 -47 -43 -45 -45 
-49 -47 -45 -45 -47 -47 -45 -47 -45 -45 
-45 -47 -45 -47 -45 -47 -47 -47 -45 -47 
-47 -47 -45 -47 -45 -45 -47 -45 -45 -45 
-45 -45 -47 -45 -47 -45 -47 -47 -47 -91 
-47 -45 -47 -45 -45 -45 -47 -47 -47 -49 
-47 -47 -47 -45 -47 -45 -47 -47 -47 -45 
-47 -49 -47 -45 -37 -47 -47 -47 -47 -45 
-47 -45 -47 -47 -45 -47 -47 -47 -45 -49 
-49 -49 -47 -49 -47 -49 -47 -49 -47 -49 
-47 -49 -47 -49 -47 -49 -91 -49 -47 -49 
-47 -49 -47 -49 -49 -49 -47 -49 -47 -37 
-89 -49 -49 -49 -47 -49 -47 -49 -49 -47 
-49 -47 -49 -47 -49 -47 -49 -47 -49 -47 
-49 -49 -49 -47 -49 -49 -49 -47 -49 -49 
-49 -49 -49 -47 -49 -47 -49 -47 -49 -47 
-49 -47 -49 -49 -49 -49 -47 -47 -47 -49 
-47 -49 -47 -49 -47 -49 -47 -49 -47 -49 
-47 -49 -47 -49 -49 -49 -47 -49 -47 -47 
-49 -47 -49 -49 -47 -49 -47 -49 -49 -49 
-49 -49 -49 -49 -47 -49 -49 -47 -49 -47 
-49 -47 -49 -47 -49 -47 -49 -47 -49 -47 
-47 -47 -45 -47 -47 -47 -47 -45 -47 -45 
-47 -47 -47 -47 -45 -47 -47 -47 -45 -49 
-49 -49 -47 -49 -49 -49 -47 -49 -47 -49 
-47 -49 -47 -49 -47 -49 -47 -49 -47 -49 
-47 -49 -47 -49 -47 -49 -49 -49 -47 -49 
-47 -49 -47 -49 -47 -49 -49 -49 -47 -49 
-91 -49 -49 -49 -47 -49 -49 -49 -55 -49 
-49 -47 -49 -47 -49 -47 -49 -47 -49 -49 
-49 -47 -49 -47 -49 -49 -49 -47 -49 -47 
-47 -49 -47 -49 -47 -49 -49 -47 -49 -47 
-49 -47 -49 -49 -49 -47 -49 -49 -49 -47 
-49 -49 -47 -49 -47 -49 -47 -49 -47 -49 
-47 -49 -47 -49 -47 -49 -49 -49 -47 -49 
-47 -49 -47 -47 -49 -47 -49 -47 -49 -47 
-49 -47 -49 -47 -49 -47 -49 -49 -47 -49 
-49 -49 -47 -47 -49 -47 -47 -49 -47 -49 
-47 -49 -47 -49 -47 -49 -47 -49 -47 -49 
-47 -49 -49 -47 -49 -47 -49 -47 -49 -47 
-49 -47 -49 -49 -49 -47 -49 -47 -49 -49 
-49 -47 -49 -47 -49 -47 -51 -49 -49 -49 
-47 -49 -47 -49 -47 -49 -49 -47 -49 -47 
-49 -47 -49 -49 -47 -49 -47 -49 -49 -49 
-49 -49 -47 -49 -47 -49 -47 -49 -47 -91 
-49 -47 -49 -47 -49 -47 -49 -47 -49 -91 
-49 -47 -47 -45 -49 -47 -49 -49 -49 -47 
-49 -47 -49 -47 -49 -49 -47 -49 -47 -49 
-47 -47 -47 -49 -47 -49 -47 -49 -47 -49 
-47 -49 -47 -49 -47 -49 -49 -49 -47 -49 
-47 -49 -47 -49 -47 -49 -47 -49 -49 -47 
-47 -49 -47 -49 -47 -49 -49 -49 -47 -49 
-49 -49 -49 -49 -47 -49 -47 -49 -47 -49 
-47 -49 -47 -49 -47 -49 -49 -47 -47 -49 
-45 -49 -49 -49 -47 -49 -49 -47 -47 -47 
-47 -49 -49 -49 -47 -49 -49 -49 -49 -49 
-49 -49 -47 -49 -49 -47 -49 -49 -47 -49 
-47 -49 -49 -47 -47 -49 -49 -49 -47 -49 
-45 -49 -47 -49 -47 -49 -49 -47 -49 -47 
-49 -49 -49 -49 -47 -49 -47 -55 -55 -49 
-47 -47 -49 -47 -49 -47 -49 -47 -49 -49 
-49 -47 -49 -47 -49 -47 -49 -47 -49 -47 
-47 -49 -47 -49 -47 -49 -47 -49 -47 -49 
-47 -49 -47 -49 -47 -51 -49 -49 -47 -49 
-47 -49 -47 -47 -49 -45 -49 -47 -49 -91 
-47 -47 -49 -47 -49 -47 -49 -47 -47 -47 
-49 -49 -47 -47 -49 -47 -49 -47 -47 -45 
-47 -51 -49 -47 -47 -49 -47 -51 -49 -49 
-47 -47 -47 -49 -47 -51 -51 -49 -47 -47 
-47 -49 -49 -49 -49 -49 -47 -49 -49 -47 
-49 -47 -49 -49 -49 -49 -47 -49 -49 -49 
-47 -49 -49 -51 -49 -49 -49 -51 -47 -47 
-49 -63 -49 -49 -49 -47 -49 -47 -51 -49 
-49 -47 -49 -49 -49 -47 -49 -49 -49 -45 
-51 -47 -47 -47 -49 -47 -49 -49 -49 -49 
-49 -47 -49 -47 -47 -47 -47 -47 -49 -47 
-47 -47 -51 -49 -49 -47 -49 -51 -49 -49 
-49 -45 -43 -49 -53 -53 -51 -51 -51 -49 
-49 -51 -53 -53 -53 -53 -53 -53 -57 -55 
-47 -47 -47 -49 -47 -49 -47 -49 -47 -49 
-49 -49 -49 -47 -49 -51 -47 -45 -49 -47 
-49 -47 -47 -47 -47 -49 -47 -49 -49 -47 
-45 -49 -47 -49 -47 -49 -47 -45 -49 -47 
-51 -49 -49 -47 -49 -47 -47 -47 -49 -47 
-49 -47 -47 -45 -49 -49 -47 -47 -47 -49 
-47 -49 -47 -49 -47 -49 -47 -49 -47 -49 
-47 -49 -47 -47 -47 -49 -49 -49 -49 -49 
-47 -49 -47 -47 -47 -49 -47 -89 -49 -47 
-47 -47 -49 -47 -47 -47 -49 -47 -49 -47 
-49 -49 -49 -47 -51 -49 -49 -49 -47 -47 
-49 -49 -49 -49 -47 -49 -91 -49 -49 -51 
-49 -49 -49 -49 -49 -51 -49 -49 -49 -47 
-49 -49 -47 -49 -47 -49 -49 -49 -47 -49 
-49 -47 -47 -49 -49 -49 -47 -49 -47 -53 
-49 -45 -45 -47 -49 -53 -51 -51 -49 -49 
-47 -45 -45 -45 -45 -47 -47 -53 -51 -53 
-53 -53 -53 -55 -51 -55 -53 -55 -53 -51 
-51 -51 -49 -51 -51 -55 -53 -51 -51 -51 
-47 -49 -47 -49 -47 -51 -47 -49 -49 -47 
-45 -47 -45 -47 -47 -47 -47 -45 -51 -49 
-51 -51 -47 -47 -47 -45 -47 -47 -47 -45 
-45 -45 -45 -47 -57 -47 -47 -45 -45 -47 
-47 -47 -47 -47 -47 -51 -49 -51 -51 -49 
-47 -51 -49 -49 -49 -47 -43 -47 -49 -47 
-45 -57 -59 -55 -53 -53 -51 -51 -49 -45 
-47 -47 -47 -47 -49 -49 -49 -47 -39 -49 
-47 -47 -47 -47 -47 -47 -45 -47 -47 -47 
-45 -49 -47 -49 -47 -47 -47 -49 -47 -49 
-47 -49 -47 -49 -47 -49 -47 -49 -47 -49 
-47 -49 -47 -49 -47 -49 -47 -47 -47 -47 
-49 -47 -49 -47 -49 -47 -49 -47 -49 -47 
-49 -47 -47 -49 -47 -47 -47 -47 -49 -49 
-49 -47 -49 -47 -49 -47 -49 -49 -49 -47 
-47 -49 -47 -49 -47 -49 -47 -49 -49 -47 
-47 -49 -47 -47 -47 -49 -47 -47 -47 -49 
-47 -49 -47 -47 -49 -47 -47 -47 -47 -47 
-47 -47 -47 -47 -47 -47 -47 -47 -47 -47 
-47 -49 -47 -47 -49 -47 -47 -45 -47 -45 
-49 -45 -47 -47 -51 -47 -49 -47 -49 -47 
-45 -45 -45 -49 -47 -51 -49 -51 -51 -49 
-49 -45 -47 -47 -49 -47 -47 -47 -47 -45 
-47 -47 -51 -47 -47 -47 -45 -47 -47 -47 
-47 -47 -47 -47 -47 -49 -47 -47 -47 -49 
-47 -49 -47 -49 -47 -49 -47 -49 -49 -49 
-47 -49 -49 -49 -47 -49 -47 -49 -47 -47 
-47 -49 -47 -49 -47 -49 -45 -49 -47 -47 
-47 -47 -47 -49 -47 -49 -49 -49 -49 -47 
-47 -49 -47 -47 -47 -49 -49 -49 -47 -51 
-47 -91 -51 -49 -51 -49 -51 -49 -49 -49 
-49 -49 -51 -49 -49 -47 -49 -47 -49 -49 
-49 -47 -49 -47 -49 -33 -49 -49 -49 -47 
-51 -49 -49 -47 -49 -49 -49 -47 -49 -49 
-51 -47 -49 -49 -49 -49 -47 -49 -49 -53 
-37 -49 -47 -49 -49 -49 -49 -49 -49 -49 
-47 -49 -49 -49 -49 -49 -49 -49 -49 -47 
-49 -47 -49 -47 -49 -49 -51 -47 -49 -47 
-49 -49 -47 -49 -47 -49 -49 -49 -47 -49 
-47 -49 -47 -49 -49 -51 -49 -49 -47 -49 
-47 -49 -49 -49 -51 -49 -49 -49 -49 -49 
-47 -49 -49 -49 -49 -49 -47 -49 -49 -49 
-49 -49 -49 -49 -49 -49 -47 -49 -49 -47 
-51 -49 -49 -47 -49 -49 -49 -47 -55 -55 
-51 -49 -51 -49 -49 -49 -51 -47 -49 -49 
-49 -49 -47 -49 -49 -51 -49 -49 -47 -49 
-49 -49 -49 -49 -49 -49 -49 -47 -49 -47 
-51 -49 -51 -49 -51 -47 -49 -49 -51 -47 
-49 -49 -49 -49 -51 -49 -51 -47 -49 -49 
-49 -49 -49 -47 -49 -51 -47 -51 -47 -49 
-47 -49 -49 -49 -49 -51 -37 -51 -49 -49 
-49 -49 -47 -49 -49 -49 -47 -49 -49 -49 
-47 -49 -49 -49 -47 -49 -47 -51 -49 -49 
-49 -49 -49 -49 -47 -49 -49 -51 -49 -57 
-57 -49 -47 -49 -49 -49 -49 -49 -49 -47 
-49 -47 -49 -47 -49 -47 -49 -47 -47 -47 
-47 -45 -47 -45 -47 -45 -47 -45 -47 -47 
-47 -47 -49 -47 -47 -47 -47 -45 -47 -47 
-45 -47 -47 -49 -49 -51 -49 -49 -51 -53 
-49 -53 -51 -53 -51 -51 -49 -49 -51 -47 
-49 -47 -49 -47 -49 -49 -49 -49 -53 -51 
-51 -51 -51 -49 -49 -49 -47 -49 -49 -49 
-87 -51 -49 -51 -49 -53 -53 -51 -51 -51 
-49 -53 -51 -51 -51 -51 -49 -51 -49 -51 
-49 -51 -51 -49 -49 -47 -47 -49 -49 -51 
-49 -49 -49 -49 -49 -51 -49 -49 -49 -49 
-49 -49 -51 -51 -51 -49 -51 -51 -51 -51 
-51 -51 -51 -51 -51 -49 -49 -47 -51 -49 
-51 -49 -49 -79 -51 -47 -49 -49 -49 -49 
-49 -47 -49 -47 -91 -49 -49 -47 -49 -49 
-47 -47 -47 -47 -49 -47 -49 -47 -47 -47 
-91 -91 -49 -47 -49 -47 -49 -49 -49 -47 
-49 -47 -49 -47 -47 -47 -47 -47 -47 -49 
-47 -47 -47 -47 -47 -49 -49 -47 -49 -47 
-49 -49 -51 -49 -59 -47 -49 -49 -49 -47 
-49 -47 -47 -47 -47 -47 -49 -47 -47 -47 
-47 -47 -49 -47 -49 -49 -49 -47 -49 -49 
-49 -47 -49 -49 -47 -49 -47 -49 -47 -47 
-47 -47 -47 -47 -47 -47 -45 -47 -47 -47 
-47 -47 -49 -47 -47 -47 -47 -47 -47 -47 
-47 -47 -47 -49 -45 -47 -45 -47 -47 -47 
-45 -47 -47 -49 -47 -47 -47 -47 -47 -47 
-69 -47 -47 -47 -47 -47 -47 -47 -49 -47 
-47 -47 -47 -45 -49 -45 -47 -47 -49 -47 
-49 -91 -49 -49 -49 -49 -47 -49 -55 -47 
-47 -49 -45 -47 -47 -47 -47 -47 -47 -47 
-45 -47 -49 -47 -49 -47 -49 -47 -49 -47 
