-53 -55 -53 -55 -53 -53 -55 -53 -55 -55 
-55 -55 -55 -55 -55 -55 -55 -55 -53 -55 
-55 -55 -53 -53 -55 -55 -53 -55 -55 -53 
-55 -53 -53 -53 -55 -55 -55 -55 -55 -55 
-55 -53 -53 -55 -55 -53 -55 -55 -57 -57 
-53 -55 -53 -55 -53 -55 -55 -55 -55 -55 
-53 -55 -53 -55 -53 -55 -53 -55 -53 -57 
-53 -55 -55 -55 -55 -55 -53 -55 -53 -55 
-55 -55 -53 -55 -53 -55 -55 -55 -55 -53 
-71 -53 -57 -55 -57 -55 -55 -55 -57 -55 
-55 -53 -55 -55 -57 -53 -57 -53 -57 -53 
-53 -55 -55 -53 -55 -55 -55 -55 -55 -53 
-57 -53 -55 -55 -55 -55 -55 -55 -55 -53 
-55 -53 -55 -55 -55 -55 -55 -55 -55 -53 
-55 -53 -55 -53 -55 -55 -55 -55 -55 -53 
-55 -53 -53 -53 -57 -53 -55 -53 -55 -55 
-57 -53 -55 -53 -57 -55 -53 -53 -55 -55 
-53 -55 -55 -55 -53 -55 -53 -55 -53 -53 
-53 -55 -53 -55 -55 -55 -53 -55 -55 -53 
-53 -55 -53 -71 -55 -55 -55 -55 -53 -55 
-55 -55 -55 -55 -53 -55 -53 -55 -55 -57 
-53 -55 -53 -55 -53 -55 -53 -55 -53 -55 
-55 -55 -53 -57 -55 -57 -55 -55 -55 -55 
-55 -55 -53 -53 -55 -53 -55 -55 -55 -53 
-55 -53 -57 -55 -57 -55 -57 -53 -57 -55 
-53 -55 -55 -53 -55 -55 -55 -53 -55 -55 
-55 -53 -55 -55 -55 -53 -55 -55 -57 -55 
-55 -55 -55 -53 -55 -55 -55 -53 -55 -53 
-57 -53 -57 -53 -55 -55 -55 -55 -57 -53 
-55 -55 -53 -55 -53 -57 -55 -57 -55 -55 
-53 -55 -55 -55 -55 -55 -55 -57 -53 -55 
-55 -55 -53 -55 -55 -55 -53 -53 -55 -53 
-55 -53 -53 -53 -57 -55 -55 -53 -55 -55 
-55 -55 -55 -53 -57 -53 -57 -55 -57 -53 
-55 -53 -55 -53 -55 -55 -57 -53 -55 -55 
-55 -53 -55 -53 -57 -53 -55 -53 -57 -53 
-55 -55 -57 -53 -57 -53 -55 -53 -83 -55 
-57 -55 -55 -53 -55 -53 -55 -53 -55 -53 
-57 -53 -55 -53 -55 -55 -55 -55 -53 -55 
-55 -57 -55 -55 -53 -55 -53 -55 -53 -55 
-53 -55 -53 -57 -55 -57 -53 -57 -53 -57 
-53 -55 -53 -57 -55 -55 -53 -55 -53 -55 
-55 -57 -55 -55 -53 -55 -57 -55 -55 -55 
-55 -53 -55 -55 -57 -53 -57 -55 -55 -55 
-57 -53 -53 -53 -55 -55 -55 -55 -55 -55 
-55 -53 -55 -53 -55 -55 -57 -53 -55 -75 
-75 -55 -57 -55 -57 -55 -55 -53 -55 -55 
-55 -53 -55 -57 -53 -55 -55 -55 -53 -57 
-53 -55 -53 -55 -53 -55 -53 -55 -53 -55 
-55 -55 -53 -55 -53 -55 -55 -57 -55 -55 
-53 -55 -55 -55 -57 -55 -53 -55 -53 -55 
-53 -55 -53 -55 -53 -53 -53 -55 -55 -55 
-55 -53 -53 -55 -55 -55 -55 -55 -55 -57 
-55 -55 -55 -55 -55 -55 -55 -55 -55 -57 
-53 -55 -55 -55 -53 -55 -55 -55 -53 -55 
-55 -55 -55 -55 -91 -55 -53 -53 -53 -55 
-53 -55 -53 -57 -53 -55 -53 -55 -53 -55 
-55 -55 -57 -55 -55 -55 -55 -53 -55 -53 
-55 -53 -55 -53 -55 -55 -55 -53 -55 -55 
-55 -53 -55 -55 -55 -55 -55 -53 -57 -53 
-55 -53 -55 -53 -55 -55 -55 -55 -55 -55 
-55 -57 -55 -55 -55 -57 -53 -53 -53 -57 
-53 -55 -55 -55 -55 -91 -53 -55 -53 -53 
-55 -55 -55 -55 -55 -53 -53 -55 -55 -53 
-55 -55 -57 -55 -57 -55 -53 -55 -55 -55 
-71 -53 -55 -91 -55 -55 -55 -53 -55 -55 
-55 -53 -53 -53 -53 -55 -55 -55 -55 -55 
-55 -57 -55 -55 -55 -57 -55 -55 -55 -55 
-55 -55 -55 -55 -55 -55 -55 -57 -55 -53 
-53 -57 -53 -55 -55 -55 -55 -55 -53 -55 
-53 -55 -91 -55 -55 -55 -55 -57 -55 -55 
-53 -55 -55 -57 -53 -55 -53 -55 -85 -55 
-55 -61 -55 -55 -57 -53 -55 -53 -53 -55 
-55 -55 -57 -53 -55 -55 -55 -53 -53 -53 
-55 -91 -53 -55 -53 -55 -53 -53 -57 -53 
-55 -53 -55 -55 -55 -53 -55 -53 -55 -55 
-55 -53 -55 -53 -55 -55 -55 -53 -57 -53 
-55 -53 -57 -53 -55 -53 -55 -53 -55 -55 
-55 -55 -53 -57 -53 -55 -53 -55 -53 -55 
-53 -55 -53 -55 -53 -55 -53 -55 -53 -55 
-53 -53 -53 -55 -53 -55 -53 -55 -53 -55 
-53 -55 -53 -53 -53 -55 -53 -55 -53 -55 
-53 -57 -53 -53 -53 -57 -53 -55 -53 -55 
-53 -57 -53 -53 -53 -71 -53 -55 -53 -53 
-53 -55 -53 -55 -53 -55 -53 -53 -53 -55 
-53 -55 -55 -55 -53 -55 -53 -57 -53 -55 
-53 -53 -71 -53 -51 -51 -53 -53 -53 -49 
-55 -53 -53 -55 -51 -53 -53 -53 -55 -53 
-53 -53 -53 -53 -53 -53 -53 -55 -53 -53 
-95 -53 -53 -53 -53 -53 -53 -55 -55 -55 
-53 -55 -53 -53 -53 -55 -53 -53 -55 -53 
-53 -53 -55 -53 -55 -53 -55 -55 -55 -53 
-53 -53 -55 -55 -53 -53 -55 -53 -55 -55 
-53 -55 -53 -55 -55 -53 -53 -55 -53 -55 
-57 -53 -55 -53 -53 -53 -53 -55 -53 -53 
-55 -53 -55 -55 -53 -55 -53 -57 -55 -55 
-55 -55 -53 -55 -55 -57 -55 -57 -53 -55 
-53 -55 -53 -55 -55 -55 -55 -53 -53 -57 
-55 -55 -55 -55 -55 -53 -55 -55 -57 -55 
-55 -53 -55 -55 -53 -55 -53 -55 -53 -57 
-53 -53 -53 -53 -53 -53 -53 -55 -53 -55 
-53 -55 -53 -55 -53 -53 -53 -55 -55 -55 
-55 -55 -57 -55 -55 -55 -55 -57 -55 -57 
-53 -55 -55 -57 -85 -85 -55 -55 -55 -55 
-53 -55 -55 -55 -55 -55 -55 -55 -53 -55 
-53 -55 -55 -55 -57 -55 -53 -55 -55 -55 
-55 -55 -53 -55 -55 -55 -53 -55 -53 -55 
-55 -55 -53 -55 -55 -55 -55 -55 -55 -53 
-55 -55 -55 -55 -55 -53 -55 -55 -55 -53 
-55 -53 -53 -53 -53 -55 -53 -53 -53 -55 
-55 -53 -53 -53 -79 -53 -55 -53 -57 -53 
-55 -55 -55 -55 -57 -53 -55 -55 -55 -55 
-55 -57 -53 -57 -53 -55 -53 -55 -55 -55 
-53 -55 -53 -57 -53 -55 -55 -55 -55 -55 
-53 -55 -53 -53 -53 -55 -53 -53 -53 -55 
-53 -53 -53 -53 -53 -53 -55 -53 -55 -53 
-55 -53 -55 -85 -53 -53 -53 -53 -55 -55 
-53 -53 -55 -55 -53 -53 -53 -55 -55 -55 
-55 -55 -55 -55 -55 -57 -53 -55 -53 -55 
-53 -55 -53 -55 -55 -53 -55 -53 -55 -53 
-53 -53 -53 -57 -53 -55 -53 -55 -53 -53 
-53 -55 -53 -55 -53 -55 -55 -55 -55 -55 
-51 -55 -55 -55 -57 -55 -57 -55 -57 -55 
-55 -53 -55 -55 -55 -53 -55 -55 -55 -53 
-55 -55 -53 -53 -55 -53 -55 -55 -55 -91 
-55 -55 -55 -55 -55 -55 -53 -55 -53 -55 
-55 -53 -53 -55 -55 -55 -53 -55 -53 -55 
-55 -55 -53 -57 -53 -57 -55 -55 -55 -55 
-53 -55 -53 -57 -55 -53 -53 -55 -53 -55 
-53 -53 -53 -55 -55 -57 -55 -57 -53 -57 
-51 -51 -53 -53 -53 -53 -51 -51 -53 -55 
-91 -55 -53 -55 -55 -57 -57 -57 -55 -59 
-57 -91 -59 -61 -57 -59 -53 -55 -53 -55 
-55 -53 -51 -53 -51 -53 -53 -55 -53 -55 
-53 -53 -51 -53 -51 -53 -51 -49 -49 -51 
-53 -55 -55 -55 -53 -55 -53 -55 -55 -55 
-53 -53 -51 -53 -51 -51 -53 -55 -53 -53 
-51 -53 -53 -53 -53 -55 -55 -55 -53 -53 
-55 -57 -55 -55 -53 -55 -55 -55 -57 -57 
-57 -57 -59 -59 -55 -61 -59 -63 -53 -55 
-55 -59 -53 -55 -53 -57 -57 -57 -53 -55 
-55 -57 -55 -57 -55 -55 -55 -55 -53 -53 
-55 -55 -55 -55 -55 -57 -55 -57 -55 -53 
-57 -57 -53 -57 -53 -57 -59 -55 -53 -55 
-57 -57 -55 -55 -55 -57 -55 -53 -55 -55 
-53 -53 -53 -55 -55 -55 -53 -55 -55 -53 
-57 -55 -55 -57 -55 -57 -55 -55 -55 -53 
-55 -53 -55 -55 -55 -53 -55 -55 -55 -55 
-57 -55 -53 -53 -53 -55 -55 -55 -57 -57 
-55 -55 -55 -57 -55 -53 -55 -55 -55 -55 
-55 -55 -57 -55 -57 -55 -57 -55 -55 -55 
-55 -55 -55 -55 -55 -55 -55 -53 -57 -55 
-57 -55 -55 -55 -55 -53 -55 -55 -55 -55 
-55 -55 -55 -55 -55 -57 -55 -55 -55 -55 
-55 -55 -53 -55 -55 -57 -53 -55 -55 -55 
-57 -55 -57 -55 -57 -55 -55 -55 -57 -59 
-57 -57 -57 -57 -55 -55 -57 -57 -55 -57 
-57 -57 -55 -57 -55 -55 -55 -55 -55 -55 
-53 -53 -55 -55 -55 -59 -57 -59 -55 -59 
-57 -59 -55 -57 -55 -57 -53 -55 -53 -55 
-53 -53 -53 -55 -55 -53 -55 -55 -55 -55 
-57 -55 -57 -55 -57 -53 -55 -55 -55 -53 
-55 -57 -57 -55 -55 -55 -59 -57 -57 -55 
-55 -57 -57 -55 -53 -53 -55 -55 -55 -57 
-55 -55 -55 -55 -53 -53 -55 -91 -53 -55 
-55 -57 -55 -57 -55 -57 -55 -55 -53 -55 
-55 -55 -55 -55 -53 -55 -55 -55 -53 -55 
-55 -55 -57 -55 -55 -53 -55 -53 -55 -53 
-55 -53 -55 -53 -53 -59 -59 -55 -55 -55 
-53 -55 -53 -55 -53 -57 -55 -55 -53 -55 
-53 -55 -53 -55 -55 -57 -55 -55 -55 -55 
-55 -55 -53 -57 -53 -53 -55 -55 -55 -53 
-53 -53 -55 -53 -55 -53 -55 -53 -55 -53 
-57 -55 -55 -55 -55 -53 -55 -55 -57 -55 
-55 -55 -55 -57 -55 -55 -53 -55 -55 -55 
-53 -55 -55 -55 -53 -55 -53 -57 -55 -55 
-55 -57 -55 -55 -55 -57 -53 -57 -55 -55 
-55 -55 -53 -55 -53 -53 -55 -55 -53 -55 
-55 -55 -55 -55 -55 -53 -53 -55 -53 -55 
-55 -55 -53 -55 -53 -55 -53 -57 -53 -55 
-55 -55 -53 -55 -55 -55 -53 -55 -55 -55 
-55 -53 -55 -53 -55 -55 -55 -55 -55 -55 
-53 -55 -55 -53 -53 -55 -53 -55 -53 -53 
-53 -55 -53 -53 -53 -55 -53 -53 -55 -55 
-53 -55 -53 -53 -55 -53 -55 -53 -55 -55 
-53 -53 -53 -55 -53 -55 -53 -55 -55 -55 
-55 -55 -55 -53 -55 -53 -55 -55 -55 -55 
-55 -55 -55 -55 -57 -55 -55 -57 -59 -57 
-57 -55 -55 -55 -55 -55 -55 -55 -55 -53 
-55 -55 -55 -55 -55 -55 -55 -55 -55 -85 
-55 -59 -55 -57 -55 -57 -53 -55 -55 -57 
-53 -55 -55 -55 -55 -55 -53 -55 -53 -55 
-53 -55 -55 -55 -55 -55 -55 -53 -55 -53 
-55 -53 -57 -55 -55 -55 -57 -55 -57 -55 
-55 -55 -55 -55 -57 -53 -57 -55 -55 -53 
-55 -55 -55 -55 -53 -55 -55 -55 -55 -53 
-53 -55 -55 -55 -55 -55 -55 -55 -53 -55 
-53 -55 -53 -55 -53 -89 -55 -55 -53 -55 
-53 -55 -53 -55 -55 -53 -53 -53 -53 -55 
-53 -55 -55 -53 -53 -57 -53 -55 -53 -55 
-55 -55 -55 -55 -53 -55 -55 -57 -53 -55 
-55 -55 -55 -53 -55 -57 -57 -59 -55 -57 
-53 -55 -55 -55 -55 -55 -55 -53 -55 -57 
-55 -55 -57 -53 -55 -53 -55 -53 -57 -53 
-55 -53 -55 -55 -57 -55 -55 -53 -53 -55 
-55 -55 -57 -59 -55 -55 -55 -55 -53 -55 
-55 -59 -55 -53 -53 -51 -55 -55 -55 -55 
-57 -57 -57 -61 -57 -59 -57 -61 -57 -61 
-57 -59 -59 -59 -91 -55 -55 -55 -55 -55 
-57 -57 -57 -55 -55 -57 -59 -87 -55 -57 
-55 -57 -57 -55 -55 -53 -53 -79 -53 -55 
-57 -55 -53 -53 -55 -55 -55 -57 -57 -57 
-57 -57 -57 -59 -57 -59 -59 -59 -59 -61 
-57 -57 -57 -57 -57 -59 -57 -57 -57 -57 
-57 -55 -55 -55 -55 -55 -55 -55 -55 -55 
-53 -53 -53 -55 -55 -55 -55 -53 -55 -57 
-57 -59 -59 -63 -59 -63 -59 -59 -57 -59 
-55 -55 -55 -57 -61 -63 -57 -59 -57 -91 
-59 -59 -61 -57 -57 -55 -55 -53 -53 -53 
-55 -55 -53 -53 -53 -53 -55 -57 -57 -57 
-57 -57 -59 -57 -57 -57 -59 -57 -55 -57 
-57 -55 -57 -55 -55 -55 -57 -55 -57 -57 
-57 -57 -57 -57 -57 -57 -57 -57 -57 -55 
-57 -55 -57 -55 -57 -57 -55 -57 -57 -57 
-55 -55 -57 -55 -57 -57 -57 -55 -57 -55 
-57 -57 -55 -55 -55 -57 -57 -55 -57 -57 
-57 -57 -55 -55 -65 -65 -57 -55 -55 -55 
-57 -57 -57 -57 -55 -55 -55 -55 -57 -55 
-55 -55 -55 -57 -57 -55 -55 -55 -57 -55 
-55 -55 -55 -55 -55 -55 -55 -55 -55 -57 
-55 -55 -55 -57 -57 -55 -55 -55 -55 -57 
-57 -57 -57 -57 -57 -55 -57 -57 -55 -57 
-57 -57 -55 -57 -57 -55 -57 -57 -55 -55 
-57 -55 -57 -57 -57 -55 -55 -57 -55 -55 
-55 -57 -57 -55 -57 -57 -57 -57 -57 -55 
-57 -57 -55 -85 -57 -55 -55 -57 -55 -55 
-55 -55 -57 -55 -55 -57 -55 -55 -55 -55 
-55 -55 -55 -55 -57 -55 -55 -55 -55 -57 
-55 -55 -55 -55 -55 -55 -55 -55 -55 -55 
-55 -55 -57 -57 -55 -55 -55 -55 -55 -55 
-55 -57 -55 -55 -57 -55 -55 -55 -55 -55 
-55 -55 -55 -55 -55 -55 -55 -57 -55 -55 
-55 -55 -55 -55 -55 -55 -55 -57 -55 -55 
-55 -55 -55 -59 -55 -57 -55 -55 -57 -57 
-55 -57 -55 -57 -57 -55 -55 -55 -57 -39 
-55 -55 -55 -55 -55 -57 -55 -57 -57 -55 
-57 -55 -55 -55 -55 -55 -55 -55 -57 -55 
-55 -57 -55 -55 -57 -55 -55 -55 -57 -57 
-57 -55 -55 -55 -55 -57 -57 -55 -57 -57 
-55 -55 -57 -55 -55 -55 -57 -55 -57 -55 
-55 -57 -57 -57 -55 -57 -91 -55 -55 -55 
-55 -55 -55 -57 -55 -53 -53 -55 -55 -55 
-53 -55 -55 -55 -55 -55 -55 -53 -53 -55 
-53 -53 -55 -55 -53 -53 -55 -55 -55 -55 
-55 -57 -55 -55 -55 -57 -55 -55 -57 -57 
-55 -57 -57 -57 -55 -57 -57 -57 -57 -57 
-57 -57 -57 -57 -57 -57 -57 -57 -59 -59 
-57 -57 -57 -57 -57 -57 -57 -57 -57 -57 
-57 -57 -57 -55 -57 -57 -57 -59 -57 -57 
-57 -57 -57 -57 -55 -57 -57 -57 -57 -57 
-59 -57 -57 -57 -91 -57 -57 -57 -57 -57 
-57 -57 -91 -57 -55 -57 -59 -57 -57 -57 
-57 -57 -57 -57 -57 -57 -55 -55 -57 -57 
-57 -57 -57 -69 -57 -55 -55 -55 -57 -57 
-57 -55 -57 -57 -57 -57 -57 -57 -57 -57 
-59 -57 -57 -55 -57 -55 -57 -57 -57 -55 
-55 -55 -55 -57 -57 -57 -59 -61 -65 -59 
-59 -55 -55 -53 -53 -53 -53 -55 -57 -57 
-61 -59 -63 -59 -55 -59 -57 -59 -57 -59 
-55 -55 -55 -53 -53 -57 -55 -57 -53 -57 
-59 -53 -53 -53 -55 -55 -55 -55 -55 -53 
-53 -53 -53 -57 -55 -55 -53 -55 -53 -53 
-53 -55 -55 -55 -53 -55 -53 -53 -55 -55 
-69 -69 -55 -55 -55 -55 -53 -55 -53 -53 
-55 -55 -55 -55 -53 -55 -53 -55 -53 -55 
-55 -55 -53 -55 -53 -53 -53 -55 -53 -55 
-55 -55 -53 -55 -53 -55 -53 -53 -55 -55 
-53 -55 -53 -55 -53 -55 -51 -53 -55 -55 
-53 -55 -53 -55 -53 -55 -55 -55 -53 -55 
-53 -53 -53 -55 -53 -55 -53 -55 -55 -55 
-53 -55 -53 -55 -53 -55 -53 -55 -51 -55 
-53 -55 -53 -91 -55 -55 -53 -55 -53 -53 
-53 -55 -53 -55 -53 -55 -53 -53 -53 -53 
-61 -53 -55 -53 -53 -55 -57 -55 -55 -53 
-55 -53 -57 -55 -55 -55 -57 -55 -55 -57 
-55 -55 -55 -55 -55 -57 -59 -53 -55 -55 
-55 -53 -55 -53 -55 -55 -55 -53 -53 -53 
-53 -53 -55 -53 -55 -53 -53 -55 -55 -55 
-53 -55 -53 -53 -55 -55 -55 -53 -55 -55 
-55 -53 -57 -55 -55 -53 -55 -53 -55 -55 
-55 -55 -55 -53 -55 -53 -55 -53 -55 -55 
-55 -53 -55 -55 -53 -53 -53 -55 -53 -53 
-57 -55 -55 -57 -55 -57 -55 -57 -57 -57 
-55 -57 -53 -53 -53 -55 -53 -55 -53 -53 
-55 -55 -53 -51 -53 -57 -59 -57 -57 -61 
-61 -57 -59 -59 -59 -59 -59 -57 -57 -55 
-57 -55 -57 -53 -55 -53 -55 -53 -51 -51 
-53 -53 -55 -57 -39 -55 -55 -53 -55 -55 
-55 -53 -53 -53 -55 -53 -53 -53 -55 -55 
-55 -55 -55 -55 -57 -53 -57 -55 -55 -55 
