-51 -51 -53 -51 -53 -53 -55 -51 -53 -61 
-51 -51 -55 -53 -53 -53 -51 -91 -51 -53 
-51 -55 -51 -51 -53 -53 -55 -51 -53 -51 
-53 -55 -53 -51 -53 -51 -53 -53 -55 -55 
-61 -55 -57 -55 -55 -59 -59 -59 -59 -61 
-59 -65 -63 -65 -59 -65 -55 -55 -53 -55 
-53 -55 -53 -53 -59 -61 -57 -57 -61 -61 
-57 -57 -57 -59 -55 -51 -51 -53 -55 -57 
-59 -53 -55 -53 -55 -55 -55 -55 -55 -55 
-55 -55 -55 -59 -59 -55 -57 -55 -55 -57 
-57 -59 -57 -57 -59 -59 -55 -61 -61 -63 
-65 -57 -57 -61 -61 -55 -55 -55 -59 -57 
-57 -59 -55 -57 -55 -55 -57 -55 -55 -55 
-57 -57 -53 -53 -55 -53 -51 -55 -53 -53 
-53 -53 -53 -55 -55 -55 -53 -55 -53 -53 
-55 -55 -53 -53 -53 -55 -55 -55 -55 -55 
-53 -57 -57 -55 -53 -55 -55 -53 -55 -55 
-57 -55 -53 -53 -55 -55 -53 -53 -55 -55 
-53 -55 -53 -55 -59 -55 -55 -55 -55 -55 
-55 -55 -57 -59 -57 -57 -59 -57 -55 -55 
-51 -55 -55 -55 -55 -53 -55 -55 -57 -61 
-57 -61 -55 -57 -57 -57 -55 -57 -57 -59 
-57 -57 -59 -57 -59 -57 -59 -59 -61 -57 
-59 -57 -59 -57 -57 -59 -59 -61 -59 -59 
-57 -59 -57 -59 -57 -91 -57 -57 -57 -53 
-57 -57 -57 -59 -57 -59 -57 -57 -57 -57 
-57 -59 -55 -57 -59 -85 -57 -57 -59 -57 
-57 -57 -57 -57 -57 -57 -59 -57 -57 -57 
-57 -55 -57 -57 -57 -57 -59 -57 -59 -57 
-57 -59 -57 -57 -57 -57 -57 -57 -57 -57 
-57 -59 -57 -59 -57 -59 -57 -57 -57 -57 
-55 -59 -57 -57 -57 -59 -57 -59 -57 -57 
-57 -57 -57 -57 -57 -57 -57 -57 -57 -57 
-59 -55 -57 -57 -59 -57 -57 -57 -59 -57 
-57 -57 -59 -57 -57 -57 -59 -57 -57 -57 
-57 -57 -57 -57 -57 -57 -57 -57 -57 -59 
-57 -59 -57 -59 -57 -59 -57 -59 -57 -59 
-57 -59 -57 -57 -57 -59 -57 -57 -57 -59 
-55 -59 -57 -57 -57 -59 -57 -59 -57 -59 
-57 -59 -57 -57 -57 -57 -57 -57 -59 -57 
-57 -57 -57 -57 -57 -55 -59 -57 -59 -57 
-57 -91 -57 -55 -57 -57 -59 -57 -57 -57 
-53 -57 -57 -59 -55 -57 -57 -57 -55 -57 
-55 -57 -57 -57 -57 -57 -57 -57 -57 -57 
-57 -57 -57 -57 -57 -57 -57 -57 -59 -57 
-57 -57 -57 -57 -57 -57 -57 -57 -57 -57 
-57 -57 -57 -55 -57 -57 -57 -57 -59 -57 
-57 -57 -57 -55 -57 -57 -57 -57 -57 -57 
-59 -57 -57 -57 -57 -57 -57 -55 -57 -57 
-59 -59 -59 -59 -57 -59 -57 -57 -57 -57 
-57 -59 -57 -57 -57 -59 -57 -57 -57 -59 
-57 -57 -57 -59 -57 -59 -57 -59 -57 -59 
-57 -59 -57 -59 -91 -59 -57 -57 -57 -59 
-57 -59 -57 -59 -57 -57 -57 -57 -57 -59 
-57 -59 -55 -57 -55 -57 -55 -59 -57 -57 
-57 -57 -57 -57 -57 -57 -57 -59 -57 -59 
-57 -59 -57 -59 -57 -57 -57 -59 -57 -57 
-57 -59 -57 -59 -57 -59 -57 -59 -57 -59 
-57 -57 -57 -59 -57 -57 -57 -57 -57 -59 
-57 -57 -57 -57 -57 -57 -57 -57 -57 -57 
-57 -57 -57 -57 -57 -57 -57 -57 -59 -91 
-59 -57 -57 -57 -59 -57 -57 -57 -59 -57 
-57 -57 -57 -57 -57 -57 -59 -57 -57 -57 
-57 -57 -57 -91 -57 -57 -57 -57 -57 -57 
-59 -57 -59 -57 -59 -57 -57 -57 -59 -57 
-57 -57 -57 -57 -57 -57 -57 -57 -57 -57 
-57 -61 -57 -57 -57 -59 -59 -57 -59 -57 
-57 -57 -57 -57 -59 -57 -59 -57 -57 -57 
-59 -57 -59 -57 -59 -57 -57 -55 -59 -57 
-59 -57 -59 -57 -59 -57 -57 -57 -57 -55 
-59 -57 -57 -57 -59 -57 -57 -57 -59 -57 
-57 -57 -57 -57 -59 -57 -57 -57 -59 -57 
-57 -57 -59 -59 -57 -59 -59 -59 -59 -59 
-59 -59 -61 -59 -63 -57 -59 -57 -59 -61 
-57 -59 -59 -61 -57 -57 -57 -57 -55 -55 
-55 -55 -55 -55 -57 -55 -55 -57 -57 -57 
-57 -55 -57 -57 -59 -57 -61 -57 -63 -61 
-55 -59 -53 -57 -55 -57 -55 -57 -57 -57 
-59 -55 -59 -55 -59 -57 -59 -57 -61 -57 
-61 -57 -59 -57 -61 -57 -61 -57 -61 -57 
-59 -55 -59 -55 -57 -57 -59 -57 -57 -57 
-57 -57 -59 -55 -59 -55 -59 -55 -57 -57 
-57 -55 -57 -57 -59 -55 -57 -55 -59 -55 
-57 -57 -59 -57 -57 -57 -57 -57 -55 -57 
-55 -57 -55 -59 -55 -57 -55 -57 -55 -57 
-55 -57 -55 -57 -55 -57 -55 -57 -55 -57 
-57 -57 -57 -57 -55 -57 -57 -55 -55 -57 
-55 -59 -55 -57 -55 -57 -55 -57 -55 -57 
-55 -57 -55 -57 -55 -59 -55 -57 -57 -59 
-55 -57 -55 -57 -55 -57 -57 -59 -55 -59 
-55 -59 -57 -59 -57 -59 -55 -59 -57 -57 
-55 -57 -55 -57 -55 -59 -55 -57 -55 -57 
-55 -57 -55 -57 -57 -59 -55 -57 -55 -57 
-55 -57 -55 -57 -55 -57 -55 -57 -55 -57 
-57 -59 -57 -57 -57 -57 -55 -59 -55 -57 
-55 -57 -55 -57 -55 -57 -55 -59 -55 -59 
-55 -59 -55 -59 -57 -57 -55 -57 -57 -61 
-57 -59 -59 -61 -59 -83 -61 -59 -59 -61 
-57 -59 -61 -57 -59 -59 -59 -59 -57 -57 
-59 -57 -57 -59 -59 -59 -57 -59 -59 -59 
-59 -57 -59 -59 -59 -59 -59 -59 -59 -59 
-59 -59 -59 -59 -59 -59 -59 -59 -59 -55 
-57 -55 -57 -55 -55 -57 -61 -61 -57 -57 
-57 -55 -55 -57 -57 -57 -55 -55 -53 -53 
-51 -51 -53 -53 -55 -55 -55 -55 -57 -55 
-59 -59 -57 -53 -53 -57 -55 -55 -51 -65 
-51 -53 -59 -53 -59 -59 -53 -53 -53 -59 
-59 -59 -53 -51 -53 -55 -55 -57 -55 -53 
-57 -55 -53 -53 -53 -55 -53 -53 -55 -53 
-55 -55 -55 -55 -55 -53 -53 -57 -53 -55 
-57 -55 -53 -57 -55 -55 -59 -55 -55 -55 
-59 -53 -55 -57 -55 -55 -59 -55 -55 -55 
-59 -55 -59 -55 -59 -53 -59 -53 -55 -53 
-51 -53 -53 -53 -51 -55 -55 -59 -55 -57 
-55 -57 -55 -57 -57 -57 -57 -61 -53 -55 
-57 -55 -55 -53 -53 -53 -53 -53 -53 -53 
-55 -91 -51 -57 -55 -55 -53 -57 -55 -57 
-55 -53 -57 -57 -55 -57 -55 -55 -57 -57 
-57 -57 -55 -61 -55 -53 -57 -55 -53 -53 
-51 -57 -55 -53 -53 -55 -53 -57 -57 -59 
-57 -91 -55 -57 -55 -55 -55 -63 -59 -53 
-53 -53 -51 -51 -51 -51 -51 -51 -49 -49 
-51 -51 -55 -53 -55 -53 -57 -55 -53 -53 
-55 -53 -57 -57 -57 -57 -61 -55 -53 -59 
-55 -51 -57 -55 -57 -55 -53 -53 -55 -53 
-55 -55 -55 -55 -55 -53 -53 -53 -51 -57 
-57 -57 -57 -53 -53 -55 -53 -55 -57 -55 
-63 -67 -57 -59 -57 -57 -61 -61 -61 -61 
-91 -63 -61 -63 -65 -61 -63 -63 -61 -63 
-65 -63 -67 -65 -63 -61 -63 -61 -59 -57 
-59 -61 -59 -59 -61 -61 -61 -61 -61 -61 
-63 -61 -63 -61 -63 -63 -65 -61 -63 -61 
-61 -59 -63 -61 -63 -61 -65 -63 -65 -63 
-67 -63 -65 -61 -63 -61 -59 -57 -61 -61 
-59 -59 -55 -55 -57 -55 -59 -61 -61 -59 
-57 -57 -57 -55 -59 -59 -61 -61 -57 -59 
-57 -59 -57 -57 -55 -55 -55 -57 -57 -57 
-57 -55 -55 -53 -53 -53 -51 -49 -49 -53 
-51 -53 -53 -53 -51 -51 -55 -55 -55 -55 
-53 -53 -53 -51 -53 -51 -53 -51 -57 -57 
-59 -59 -57 -55 -59 -57 -55 -57 -57 -57 
-57 -55 -57 -55 -55 -53 -55 -55 -55 -59 
-59 -59 -61 -57 -57 -59 -59 -59 -59 -61 
-61 -61 -59 -61 -63 -63 -67 -63 -67 -61 
-61 -59 -59 -55 -55 -57 -57 -55 -77 -53 
-55 -57 -59 -61 -87 -57 -59 -57 -57 -57 
-57 -55 -59 -57 -57 -55 -57 -59 -57 -55 
-57 -59 -59 -57 -59 -57 -57 -57 -57 -57 
-59 -57 -59 -57 -55 -55 -57 -57 -55 -55 
-57 -55 -55 -55 -57 -57 -57 -57 -57 -57 
-59 -55 -55 -55 -57 -57 -59 -59 -61 -57 
-63 -59 -59 -57 -57 -59 -57 -57 -57 -55 
-55 -55 -55 -57 -59 -59 -59 -61 -57 -57 
-57 -59 -61 -57 -59 -59 -59 -59 -57 -59 
-59 -57 -57 -57 -57 -59 -59 -57 -59 -57 
-57 -57 -59 -57 -55 -59 -57 -57 -57 -59 
-59 -59 -59 -59 -57 -57 -57 -55 -59 -59 
-57 -59 -57 -57 -91 -57 -57 -59 -59 -57 
-55 -57 -57 -59 -57 -59 -57 -57 -59 -57 
-55 -55 -59 -55 -57 -59 -57 -59 -57 -57 
-57 -57 -57 -57 -55 -57 -57 -57 -57 -57 
-57 -57 -57 -57 -57 -57 -57 -55 -57 -59 
-57 -59 -59 -59 -57 -59 -57 -59 -57 -59 
-57 -59 -59 -59 -57 -57 -59 -59 -57 -59 
-57 -57 -59 -57 -59 -57 -57 -57 -57 -57 
-57 -57 -57 -57 -57 -57 -57 -57 -57 -59 
-57 -57 -57 -59 -55 -57 -59 -57 -57 -57 
-57 -57 -59 -57 -57 -57 -59 -57 -57 -57 
-57 -57 -57 -59 -57 -57 -59 -57 -57 -57 
-57 -91 -57 -57 -57 -59 -57 -53 -57 -59 
-57 -57 -59 -57 -57 -57 -57 -57 -57 -57 
-57 -59 -57 -57 -57 -59 -59 -89 -59 -57 
-57 -59 -57 -59 -59 -57 -59 -57 -57 -57 
-57 -57 -59 -57 -57 -57 -59 -57 -57 -57 
-57 -59 -57 -57 -59 -57 -59 -57 -57 -57 
-57 -57 -57 -57 -59 -57 -57 -59 -59 -57 
-57 -55 -57 -57 -57 -57 -57 -59 -57 -55 
-57 -55 -57 -57 -59 -57 -57 -57 -57 -55 
-57 -57 -57 -59 -55 -57 -55 -57 -57 -57 
-57 -55 -55 -57 -57 -59 -57 -55 -57 -57 
-57 -57 -57 -57 -57 -57 -57 -57 -55 -55 
-55 -55 -57 -57 -57 -59 -59 -57 -59 -59 
-61 -61 -61 -59 -57 -61 -59 -59 -57 -55 
-57 -59 -57 -57 -57 -61 -63 -57 -57 -57 
-57 -55 -57 -59 -59 -55 -57 -57 -57 -57 
-57 -59 -61 -59 -59 -59 -53 -55 -61 -59 
-57 -59 -55 -53 -57 -55 -57 -57 -53 -53 
-55 -57 -57 -55 -55 -53 -57 -59 -55 -53 
-55 -55 -55 -53 -59 -59 -59 -61 -59 -61 
-59 -61 -57 -55 -57 -57 -57 -57 -57 -57 
-59 -57 -55 -55 -61 -63 -63 -61 -61 -63 
-91 -61 -63 -57 -61 -57 -91 -63 -59 -63 
-59 -61 -59 -61 -57 -59 -55 -59 -55 -61 
-59 -57 -59 -57 -59 -57 -59 -57 -57 -57 
-59 -87 -59 -57 -61 -55 -57 -59 -61 -59 
-63 -59 -63 -57 -57 -61 -61 -59 -57 -59 
-59 -59 -59 -61 -59 -59 -59 -59 -59 -57 
-57 -59 -57 -59 -59 -59 -59 -59 -59 -63 
-57 -57 -57 -59 -57 -57 -57 -57 -57 -59 
-55 -57 -59 -59 -57 -57 -57 -57 -55 -59 
-57 -57 -59 -57 -57 -59 -57 -57 -57 -59 
-57 -59 -55 -59 -57 -53 -55 -53 -59 -57 
-53 -55 -55 -57 -59 -65 -65 -61 -63 -61 
-63 -63 -65 -57 -61 -57 -59 -59 -61 -57 
-59 -51 -53 -51 -49 -55 -51 -51 -51 -53 
-53 -51 -55 -53 -51 -51 -53 -51 -55 -57 
-57 -57 -59 -59 -59 -61 -57 -59 -57 -57 
-59 -61 -59 -57 -55 -57 -55 -57 -59 -61 
-57 -57 -53 -55 -57 -57 -59 -61 -61 -61 
-57 -59 -57 -91 -55 -55 -57 -57 -57 -57 
-59 -57 -57 -55 -53 -53 -55 -55 -53 -53 
-59 -57 -55 -55 -55 -53 -57 -57 -59 -57 
-55 -55 -57 -57 -59 -59 -53 -53 -53 -53 
-51 -51 -53 -51 -57 -55 -55 -55 -53 -53 
-57 -57 -59 -61 -57 -55 -59 -59 -63 -61 
-61 -61 -61 -63 -61 -63 -59 -61 -59 -61 
-61 -65 -61 -61 -63 -61 -65 -61 -65 -63 
-65 -63 -63 -63 -61 -65 -63 -63 -63 -63 
-63 -63 -59 -55 -55 -55 -55 -51 -55 -55 
-57 -59 -57 -59 -59 -59 -59 -59 -57 -59 
-61 -63 -61 -61 -61 -57 -61 -57 -53 -57 
-59 -59 -61 -59 -59 -55 -55 -55 -53 -59 
-59 -53 -55 -61 -51 -49 -45 -45 -53 -55 
-55 -57 -57 -51 -49 -49 -51 -49 -49 -47 
-55 -55 -55 -51 -51 -53 -53 -53 -53 -53 
-53 -53 -55 -53 -57 -55 -59 -57 -55 -53 
-55 -55 -59 -57 -61 -61 -55 -55 -55 -53 
-53 -55 -53 -53 -53 -53 -53 -55 -55 -53 
-53 -55 -57 -57 -55 -55 -55 -57 -57 -55 
-57 -57 -53 -57 -59 -59 -61 -65 -59 -61 
-65 -63 -63 -61 -59 -57 -59 -57 -63 -59 
-55 -55 -55 -61 -61 -61 -61 -59 -59 -59 
-57 -53 -55 -55 -53 -53 -51 -51 -51 -53 
-53 -51 -59 -61 -59 -61 -63 -61 -59 -57 
-57 -59 -59 -63 -57 -55 -55 -53 -57 -57 
-53 -55 -53 -53 -53 -53 -55 -53 -59 -57 
-57 -57 -53 -55 -53 -53 -53 -51 -55 -53 
-55 -55 -55 -87 -55 -55 -53 -53 -55 -53 
-55 -53 -55 -55 -53 -57 -55 -57 -57 -55 
-57 -57 -59 -57 -55 -55 -59 -61 -57 -57 
-59 -57 -55 -57 -53 -53 -55 -55 -53 -55 
-55 -59 -59 -57 -59 -57 -55 -53 -53 -51 
-51 -59 -59 -59 -57 -53 -53 -55 -53 -51 
-49 -61 -63 -51 -51 -53 -53 -51 -49 -53 
-49 -47 -49 -53 -51 -53 -53 -53 -55 -53 
-51 -55 -53 -55 -55 -53 -57 -55 -57 -57 
-53 -55 -57 -57 -55 -53 -55 -51 -53 -51 
-55 -55 -57 -55 -51 -51 -53 -51 -53 -53 
-53 -53 -53 -53 -55 -53 -53 -51 -55 -55 
-91 -55 -55 -55 -55 -53 -55 -53 -53 -51 
-53 -51 -55 -53 -53 -53 -55 -53 -53 -51 
-51 -49 -51 -51 -51 -51 -53 -53 -55 -53 
-55 -53 -55 -55 -53 -55 -55 -55 -57 -57 
-53 -51 -53 -53 -51 -73 -51 -51 -53 -51 
-53 -51 -53 -53 -57 -57 -59 -57 -91 -57 
-57 -57 -55 -59 -59 -57 -57 -55 -57 -57 
-55 -57 -55 -55 -55 -57 -55 -57 -57 -57 
-57 -57 -57 -57 -57 -57 -57 -57 -59 -57 
-57 -57 -57 -57 -57 -57 -57 -57 -59 -57 
-57 -57 -57 -55 -55 -57 -57 -55 -57 -57 
-57 -57 -57 -57 -57 -57 -57 -59 -57 -57 
-57 -57 -59 -57 -55 -55 -57 -57 -57 -55 
-57 -57 -55 -57 -57 -57 -57 -57 -55 -57 
-57 -57 -57 -55 -59 -55 -55 -57 -57 -57 
-59 -57 -59 -57 -57 -57 -57 -57 -57 -57 
-57 -57 -57 -57 -57 -57 -57 -57 -57 -57 
-57 -57 -57 -57 -57 -57 -57 -57 -57 -57 
-55 -57 -55 -57 -57 -57 -57 -57 -57 -57 
-57 -57 -57 -55 -57 -57 -57 -57 -55 -57 
-57 -57 -57 -57 -57 -57 -57 -55 -91 -57 
-57 -57 -55 -57 -59 -57 -59 -57 -57 -57 
-57 -57 -55 -57 -57 -83 -57 -57 -57 -57 
-57 -57 -59 -57 -57 -59 -57 -57 -59 -57 
-57 -57 -57 -57 -57 -57 -57 -57 -57 -57 
-57 -57 -57 -57 -55 -57 -57 -57 -57 -61 
-57 -57 -55 -57 -57 -57 -57 -57 -57 -57 
-57 -57 -57 -57 -57 -57 -57 -57 -57 -57 
-57 -55 -59 -57 -57 -57 -59 -57 -57 -57 
-57 -57 -57 -57 -55 -57 -55 -57 -57 -57 
-55 -57 -57 -57 -57 -57 -55 -55 -55 -57 
-57 -57 -55 -57 -57 -57 -55 -55 -57 -57 
-57 -57 -55 -57 -57 -55 -57 -57 -57 -57 
-57 -57 -57 -57 -57 -57 -57 -57 -57 -57 
-57 -57 -57 -55 -57 -57 -57 -55 -55 -55 
-57 -55 -57 -55 -57 -57 -55 -57 -57 -55 
-55 -57 -57 -55 -55 -57 -57 -61 -57 -57 
-57 -57 -55 -57 -55 -57 -57 -57 -57 -57 
-57 -57 -55 -55 -55 -57 -57 -57 -55 -57 
-57 -57 -57 -57 -55 -57 -57 -57 -55 -57 
-57 -55 -57 -55 -55 -55 -55 -57 -55 -57 
-55 -57 -57 -55 -55 -57 -57 -57 -57 -91 
-57 -57 -57 -57 -57 -55 -57 -55 -55 -57 
-57 -57 -57 -55 -57 -57 -57 -57 -57 -57 
-57 -57 -57 -57 -55 -57 -57 -57 -57 -57 
-57 -57 -57 -57 -57 -57 -57 -57 -57 -57 
-57 -55 -57 -57 -57 -57 -55 -57 -57 -57 
-57 -57 -57 -55 -57 -57 -57 -55 -55 -57 
-57 -57 -57 -57 -57 -57 -55 -57 -55 -57 
-57 -57 -57 -57 -57 -57 -57 -55 -55 -57 
-57 -57 -57 -55 -57 -55 -59 -57 -57 -57 
