-69 -69 -71 -71 -71 -71 -69 -69 -71 -69 
-69 -71 -69 -71 -71 -71 -71 -69 -71 -69 
-69 -71 -71 -71 -69 -69 -73 -69 -71 -69 
-71 -69 -71 -69 -71 -69 -71 -69 -71 -71 
-71 -71 -69 -73 -69 -73 -69 -71 -71 -71 
-69 -69 -71 -71 -69 -71 -71 -71 -69 -69 
-69 -71 -69 -71 -69 -71 -71 -73 -69 -69 
-69 -69 -71 -69 -69 -69 -71 -69 -71 -69 
-69 -69 -69 -69 -69 -69 -71 -71 -71 -71 
-69 -69 -71 -71 -71 -71 -71 -73 -69 -71 
-69 -69 -69 -73 -69 -71 -73 -71 -71 -69 
-71 -69 -71 -71 -69 -71 -71 -69 -69 -67 
-69 -71 -71 -71 -69 -71 -69 -71 -71 -71 
-69 -71 -69 -71 -71 -71 -71 -71 -73 -71 
-71 -69 -73 -71 -73 -73 -71 -73 -71 -73 
-71 -73 -73 -69 -73 -69 -71 -69 -71 -69 
-71 -69 -71 -71 -73 -71 -71 -69 -69 -69 
-71 -69 -71 -71 -71 -71 -71 -69 -71 -69 
-71 -69 -71 -69 -71 -69 -69 -69 -71 -67 
-69 -67 -69 -69 -69 -71 -71 -71 -69 -67 
-69 -69 -69 -71 -69 -69 -67 -69 -71 -71 
-71 -71 -73 -69 -71 -71 -71 -69 -71 -71 
-71 -71 -73 -71 -69 -67 -71 -69 -71 -69 
-71 -71 -71 -71 -71 -67 -69 -69 -71 -67 
-69 -69 -71 -71 -67 -73 -71 -71 -69 -69 
-69 -69 -71 -71 -71 -67 -67 -71 -71 -75 
-71 -73 -57 -57 -69 -71 -69 -71 -67 -71 
-67 -67 -69 -71 -69 -71 -69 -71 -69 -71 
-69 -71 -69 -69 -67 -71 -67 -69 -71 -67 
-69 -67 -69 -67 -69 -69 -69 -69 -69 -69 
-73 -71 -69 -73 -69 -69 -73 -69 -71 -71 
-71 -69 -73 -69 -75 -71 -75 -71 -73 -69 
-73 -69 -71 -69 -73 -69 -73 -91 -71 -69 
-71 -69 -69 -69 -67 -69 -69 -69 -69 -71 
-71 -71 -69 -71 -69 -69 -69 -73 -71 -73 
-71 -73 -71 -73 -69 -73 -71 -73 -69 -71 
-71 -71 -69 -71 -69 -69 -69 -71 -71 -73 
-71 -75 -71 -73 -71 -75 -71 -73 -71 -73 
-71 -73 -73 -69 -73 -69 -73 -71 -71 -75 
-71 -73 -71 -73 -71 -75 -71 -75 -73 -75 
-69 -73 -71 -75 -71 -75 -71 -75 -71 -73 
-71 -75 -71 -73 -69 -73 -69 -71 -75 -71 
-75 -71 -69 -73 -71 -71 -71 -73 -71 -75 
-69 -73 -71 -73 -71 -71 -73 -73 -69 -71 
-69 -71 -71 -71 -71 -69 -69 -69 -85 -69 
-71 -71 -71 -69 -71 -71 -71 -71 -71 -71 
-71 -71 -71 -71 -69 -71 -69 -73 -69 -71 
-69 -73 -73 -69 -73 -69 -71 -71 -73 -71 
-73 -69 -71 -71 -73 -71 -71 -69 -71 -69 
-71 -69 -71 -71 -71 -69 -73 -69 -71 -71 
-73 -71 -73 -69 -73 -69 -71 -69 -71 -69 
-71 -71 -73 -69 -71 -71 -71 -69 -71 -71 
-71 -71 -55 -71 -71 -71 -71 -69 -71 -69 
-69 -71 -69 -71 -69 -71 -71 -71 -71 -71 
-73 -69 -73 -69 -71 -69 -71 -69 -73 -69 
-69 -71 -71 -71 -71 -69 -73 -69 -71 -69 
-71 -71 -73 -73 -69 -69 -71 -75 -71 -71 
-71 -71 -69 -71 -69 -71 -71 -71 -71 -71 
-71 -71 -71 -71 -71 -73 -73 -73 -69 -71 
-71 -71 -69 -69 -69 -69 -69 -69 -69 -69 
-91 -69 -71 -71 -71 -69 -69 -71 -69 -73 
-71 -71 -71 -73 -69 -69 -71 -69 -71 -71 
-71 -57 -57 -69 -71 -71 -71 -71 -71 -71 
-71 -73 -71 -71 -71 -71 -71 -71 -69 -71 
-71 -73 -71 -73 -69 -71 -69 -69 -69 -69 
-69 -73 -69 -69 -71 -71 -71 -71 -71 -71 
-71 -71 -71 -71 -71 -69 -71 -69 -71 -71 
-73 -71 -73 -71 -71 -71 -71 -71 -71 -69 
-71 -69 -71 -69 -69 -71 -71 -71 -69 -71 
-69 -71 -69 -71 -69 -73 -69 -71 -71 -71 
-71 -71 -69 -71 -71 -91 -71 -73 -71 -71 
-69 -71 -69 -71 -71 -69 -73 -69 -71 -69 
-73 -69 -71 -71 -71 -71 -73 -85 -69 -71 
-69 -73 -71 -71 -71 -71 -73 -69 -73 -71 
-73 -71 -71 -69 -71 -71 -71 -69 -71 -71 
-71 -69 -71 -69 -73 -73 -71 -71 -71 -73 
-69 -71 -69 -73 -71 -73 -69 -71 -69 -73 
-69 -71 -71 -73 -69 -71 -71 -69 -71 -71 
-69 -71 -69 -71 -71 -71 -71 -73 -71 -73 
-71 -73 -71 -71 -71 -71 -69 -71 -71 -69 
-71 -71 -73 -69 -69 -71 -69 -73 -69 -71 
-71 -71 -69 -71 -71 -71 -69 -69 -69 -69 
-69 -69 -67 -69 -69 -69 -69 -71 -69 -69 
-69 -71 -71 -71 -71 -71 -71 -71 -69 -71 
-71 -69 -55 -71 -71 -71 -71 -91 -69 -71 
-69 -71 -69 -71 -71 -71 -69 -71 -69 -69 
-69 -69 -71 -71 -69 -71 -69 -69 -69 -69 
-69 -71 -71 -71 -71 -69 -71 -71 -71 -71 
-69 -69 -71 -71 -69 -69 -69 -69 -71 -69 
-69 -51 -69 -69 -69 -71 -69 -71 -69 -69 
-69 -69 -69 -69 -71 -69 -69 -71 -69 -71 
-69 -71 -71 -71 -69 -71 -71 -69 -71 -69 
-69 -71 -69 -69 -69 -71 -71 -69 -69 -71 
-69 -71 -71 -71 -71 -71 -69 -69 -71 -69 
-69 -69 -71 -69 -71 -69 -69 -69 -69 -69 
-69 -69 -69 -69 -69 -69 -71 -71 -71 -71 
-69 -69 -69 -69 -69 -69 -69 -69 -71 -69 
-71 -71 -69 -71 -69 -71 -71 -69 -69 -71 
-69 -71 -71 -71 -71 -69 -71 -69 -69 -71 
-71 -69 -71 -71 -69 -69 -69 -71 -69 -69 
-69 -71 -73 -69 -69 -71 -71 -71 -69 -69 
-69 -71 -71 -69 -69 -69 -71 -71 -71 -71 
-71 -71 -71 -71 -71 -69 -69 -69 -69 -69 
-69 -69 -71 -69 -71 -71 -69 -87 -73 -73 
-71 -71 -73 -73 -71 -73 -73 -73 -71 -71 
-73 -73 -71 -73 -71 -71 -73 -71 -71 -71 
-69 -71 -71 -71 -71 -71 -71 -71 -71 -71 
-71 -71 -73 -71 -71 -71 -71 -71 -71 -71 
-69 -69 -71 -69 -71 -71 -71 -71 -71 -71 
-91 -71 -71 -71 -73 -71 -71 -71 -71 -71 
-71 -71 -73 -71 -73 -71 -71 -71 -71 -71 
-73 -71 -71 -71 -73 -73 -71 -71 -73 -71 
-73 -71 -73 -71 -71 -73 -71 -71 -71 -71 
-71 -73 -71 -73 -71 -71 -69 -71 -69 -69 
-69 -69 -69 -69 -71 -71 -69 -73 -73 -73 
-71 -71 -71 -71 -71 -69 -71 -71 -71 -69 
-69 -71 -73 -71 -71 -71 -69 -73 -73 -71 
-71 -71 -69 -71 -73 -71 -73 -69 -71 -71 
-69 -71 -71 -69 -69 -69 -69 -71 -69 -69 
-69 -69 -71 -71 -71 -73 -69 -71 -71 -69 
-71 -71 -71 -71 -71 -71 -69 -71 -71 -71 
-71 -71 -69 -71 -71 -71 -69 -71 -73 -73 
-73 -71 -71 -71 -69 -71 -69 -71 -71 -71 
-71 -73 -73 -71 -73 -71 -73 -71 -71 -71 
-71 -71 -71 -73 -73 -73 -69 -71 -71 -71 
-71 -71 -71 -73 -69 -71 -71 -73 -69 -71 
-69 -71 -71 -69 -69 -69 -69 -69 -69 -71 
-71 -69 -71 -69 -71 -69 -69 -69 -71 -71 
-73 -71 -71 -71 -73 -71 -71 -71 -69 -71 
-69 -71 -69 -69 -73 -71 -71 -71 -71 -69 
-69 -69 -69 -71 -71 -71 -73 -71 -71 -73 
-71 -71 -71 -71 -73 -73 -73 -71 -73 -75 
-71 -73 -71 -71 -71 -73 -73 -71 -75 -71 
-73 -75 -71 -73 -73 -71 -71 -71 -69 -69 
-69 -69 -69 -69 -69 -67 -69 -67 -67 -69 
-71 -69 -71 -69 -69 -71 -71 -67 -69 -69 
-69 -69 -69 -67 -67 -71 -73 -71 -71 -69 
-67 -69 -69 -69 -69 -69 -69 -67 -67 -69 
-67 -69 -69 -69 -69 -69 -67 -73 -73 -71 
-69 -73 -75 -77 -73 -73 -71 -71 -69 -69 
-69 -69 -69 -69 -69 -69 -71 -73 -71 -71 
-69 -67 -65 -67 -67 -67 -67 -69 -69 -69 
-69 -69 -69 -69 -71 -71 -71 -73 -71 -73 
-69 -71 -73 -73 -73 -77 -71 -73 -69 -69 
-69 -71 -69 -67 -69 -69 -67 -69 -71 -69 
-69 -69 -69 -67 -71 -71 -69 -69 -71 -71 
-71 -73 -71 -73 -69 -71 -69 -71 -69 -71 
-71 -69 -71 -71 -73 -71 -69 -69 -71 -69 
-71 -69 -71 -69 -71 -71 -75 -71 -73 -71 
-71 -71 -75 -71 -73 -71 -71 -73 -75 -71 
-73 -71 -75 -73 -77 -73 -77 -73 -75 -73 
-75 -73 -75 -73 -55 -69 -71 -69 -71 -71 
-69 -71 -73 -69 -71 -69 -71 -69 -71 -69 
-71 -69 -71 -69 -71 -69 -69 -71 -73 -71 
-73 -71 -73 -71 -71 -71 -73 -71 -71 -71 
-69 -71 -71 -69 -69 -71 -71 -69 -71 -69 
-71 -71 -71 -71 -69 -73 -71 -71 -71 -69 
-71 -71 -71 -69 -71 -71 -71 -71 -69 -71 
-71 -71 -71 -71 -71 -71 -71 -69 -71 -71 
-71 -71 -71 -93 -73 -71 -73 -69 -69 -73 
-73 -71 -73 -73 -73 -69 -71 -71 -71 -69 
-71 -71 -73 -71 -71 -71 -71 -69 -69 -69 
-73 -71 -71 -69 -71 -69 -69 -71 -71 -69 
-71 -71 -69 -71 -71 -71 -71 -69 -71 -69 
-71 -69 -71 -71 -73 -71 -71 -71 -71 -71 
-71 -69 -73 -71 -73 -71 -71 -69 -69 -71 
-69 -73 -71 -73 -71 -71 -69 -71 -69 -71 
-69 -69 -69 -69 -69 -69 -71 -69 -69 -71 
-69 -69 -69 -69 -69 -71 -69 -69 -69 -69 
-69 -69 -69 -71 -69 -69 -69 -71 -69 -69 
-69 -69 -69 -69 -69 -69 -71 -71 -69 -69 
-69 -69 -69 -69 -69 -69 -69 -71 -69 -69 
-67 -69 -69 -71 -69 -71 -69 -71 -71 -69 
-69 -69 -69 -71 -69 -73 -69 -69 -69 -69 
-69 -69 -69 -69 -69 -69 -71 -69 -69 -71 
-69 -69 -69 -71 -69 -71 -71 -71 -69 -71 
-71 -71 -69 -71 -69 -71 -69 -71 -69 -71 
-71 -71 -69 -71 -69 -71 -69 -71 -69 -71 
-69 -71 -69 -71 -71 -71 -69 -71 -69 -71 
-69 -71 -69 -71 -69 -71 -73 -69 -71 -69 
-71 -69 -69 -71 -69 -71 -69 -73 -71 -73 
-69 -73 -71 -71 -69 -71 -69 -71 -69 -71 
-69 -71 -71 -71 -69 -71 -69 -69 -69 -69 
-69 -69 -69 -69 -71 -71 -71 -71 -69 -71 
-71 -69 -71 -69 -73 -69 -71 -85 -71 -71 
-71 -71 -69 -71 -69 -69 -69 -71 -71 -71 
-71 -71 -71 -75 -69 -71 -73 -69 -69 -71 
-77 -71 -71 -69 -71 -71 -69 -71 -71 -71 
-71 -71 -69 -71 -69 -69 -71 -69 -71 -67 
-71 -67 -69 -69 -71 -69 -71 -69 -71 -69 
-71 -69 -71 -69 -71 -69 -71 -69 -71 -69 
-71 -71 -71 -71 -73 -71 -73 -69 -71 -69 
-73 -71 -71 -71 -71 -73 -71 -73 -71 -73 
-69 -71 -73 -75 -71 -75 -71 -73 -71 -75 
-71 -73 -71 -73 -73 -75 -71 -73 -71 -73 
-71 -73 -71 -73 -71 -73 -73 -75 -71 -73 
-73 -71 -75 -73 -75 -73 -75 -69 -69 -71 
-71 -73 -71 -73 -71 -73 -71 -71 -69 -71 
-71 -73 -71 -73 -71 -73 -71 -71 -69 -73 
-71 -71 -71 -71 -71 -73 -69 -71 -69 -71 
-71 -71 -71 -69 -69 -69 -69 -71 -69 -71 
-73 -71 -71 -69 -71 -69 -73 -71 -71 -69 
-71 -71 -71 -69 -73 -71 -69 -71 -69 -71 
-69 -73 -71 -71 -71 -71 -71 -73 -69 -73 
-69 -71 -69 -71 -71 -73 -71 -71 -69 -71 
-69 -73 -69 -71 -69 -69 -71 -69 -71 -71 
-71 -73 -69 -71 -69 -71 -71 -71 -73 -69 
-73 -71 -73 -71 -71 -71 -69 -69 -71 -71 
-71 -71 -69 -71 -69 -71 -69 -71 -69 -73 
-69 -71 -71 -73 -71 -71 -71 -73 -69 -71 
-71 -71 -69 -71 -69 -73 -69 -73 -69 -71 
-69 -73 -69 -71 -69 -71 -69 -71 -69 -71 
-71 -73 -69 -71 -69 -73 -69 -71 -69 -71 
-69 -71 -69 -71 -69 -73 -71 -71 -71 -73 
-69 -73 -69 -71 -69 -71 -71 -73 -69 -71 
-55 -71 -71 -71 -71 -69 -71 -71 -73 -69 
-71 -71 -71 -69 -73 -69 -71 -71 -73 -71 
-71 -69 -71 -71 -73 -71 -71 -69 -71 -69 
-71 -69 -71 -69 -71 -71 -71 -71 -71 -73 
-69 -71 -69 -71 -71 -71 -69 -73 -69 -71 
-71 -71 -69 -71 -69 -71 -71 -69 -91 -69 
-71 -71 -71 -69 -71 -71 -71 -71 -71 -69 
-71 -69 -71 -71 -71 -69 -71 -71 -71 -71 
-71 -71 -63 -71 -71 -71 -69 -73 -71 -71 
-71 -69 -73 -69 -71 -71 -69 -73 -69 -71 
-71 -73 -71 -71 -71 -71 -69 -71 -71 -71 
-69 -71 -71 -71 -71 -71 -69 -71 -69 -71 
-71 -71 -69 -71 -71 -73 -71 -71 -69 -73 
-71 -71 -69 -71 -71 -71 -71 -71 -69 -71 
-69 -71 -71 -71 -69 -71 -71 -71 -69 -73 
-71 -71 -71 -71 -69 -73 -71 -71 -71 -69 
-73 -71 -71 -71 -71 -69 -71 -71 -71 -69 
-71 -69 -71 -87 -69 -71 -71 -73 -69 -71 
-69 -71 -69 -71 -69 -71 -71 -71 -69 -71 
-69 -71 -71 -71 -69 -71 -73 -69 -71 -69 
-71 -69 -71 -71 -71 -69 -73 -71 -71 -71 
-69 -71 -69 -71 -69 -73 -69 -71 -71 -71 
-71 -71 -69 -71 -69 -73 -71 -71 -69 -69 
-73 -69 -71 -71 -71 -89 -71 -71 -69 -55 
-71 -71 -69 -69 -71 -71 -71 -71 -69 -71 
-69 -71 -69 -73 -71 -71 -71 -71 -71 -71 
-71 -71 -71 -71 -69 -71 -71 -71 -69 -75 
-69 -71 -71 -71 -69 -71 -71 -71 -69 -71 
-69 -71 -71 -71 -71 -71 -69 -73 -71 -71 
-71 -73 -71 -73 -71 -71 -73 -73 -73 -73 
-71 -71 -71 -69 -71 -71 -69 -71 -71 -71 
-71 -71 -71 -71 -71 -73 -71 -71 -71 -71 
-71 -69 -73 -71 -73 -69 -73 -71 -73 -69 
-69 -73 -69 -71 -71 -71 -69 -71 -71 -71 
-71 -73 -69 -73 -69 -73 -69 -55 -71 -71 
-69 -73 -69 -73 -69 -71 -69 -71 -69 -71 
-69 -71 -71 -73 -69 -71 -69 -71 -71 -73 
-71 -73 -69 -71 -69 -73 -71 -71 -71 -71 
-73 -73 -71 -71 -71 -71 -69 -71 -71 -73 
-69 -71 -71 -69 -71 -71 -73 -71 -71 -71 
-71 -71 -73 -71 -73 -71 -71 -69 -73 -69 
-71 -69 -73 -71 -71 -71 -71 -69 -71 -69 
-71 -71 -71 -69 -73 -69 -73 -71 -71 -71 
-71 -71 -73 -69 -73 -69 -71 -69 -71 -69 
-73 -69 -73 -71 -71 -71 -71 -73 -63 -69 
-71 -71 -73 -71 -71 -69 -71 -71 -71 -71 
-71 -71 -71 -75 -91 -69 -73 -71 -73 -69 
-71 -69 -71 -69 -71 -69 -71 -69 -71 -69 
-73 -71 -69 -73 -71 -71 -71 -71 -71 -71 
-71 -71 -71 -73 -71 -73 -71 -73 -71 -71 
-73 -69 -71 -69 -71 -71 -71 -69 -73 -71 
-71 -69 -71 -69 -73 -71 -73 -69 -71 -69 
-69 -69 -71 -71 -71 -71 -71 -71 -73 -71 
-71 -71 -71 -71 -73 -71 -71 -69 -71 -69 
-71 -69 -69 -71 -69 -69 -69 -73 -71 -73 
-69 -71 -69 -69 -69 -73 -69 -71 -69 -71 
-69 -71 -71 -73 -71 -69 -71 -69 -71 -71 
-71 -67 -69 -69 -71 -69 -69 -71 -71 -71 
-71 -73 -71 -71 -69 -71 -71 -71 -71 -71 
-69 -71 -73 -69 -69 -71 -69 -71 -71 -73 
-71 -73 -71 -69 -73 -69 -73 -69 -73 -71 
-73 -71 -71 -73 -69 -71 -71 -73 -69 -71 
-69 -71 -71 -71 -73 -69 -69 -73 -71 -71 
-69 -71 -71 -69 -69 -69 -71 -69 -71 -69 
-71 -71 -71 -71 -73 -69 -69 -69 -71 -69 
-71 -71 -73 -71 -69 -71 -69 -69 -71 -71 
-69 -73 -69 -73 -69 -73 -71 -73 -69 -73 
-69 -73 -69 -71 -69 -71 -71 -71 -71 -71 
-73 -69 -71 -69 -73 -69 -71 -69 -69 -69 
-71 -71 -71 -71 -71 -71 -71 -71 -71 -71 
-71 -71 -69 -71 -71 -71 -71 -71 -71 -71 
-69 -69 -69 -71 -69 -69 -69 -71 -69 -71 
-71 -71 -71 -71 -69 -71 -71 -71 -69 -73 
-71 -71 -71 -71 -69 -69 -71 -73 -69 -71 
-71 -73 -69 -71 -69 -73 -73 -91 -71 -69 
-71 -69 -73 -69 -71 -71 -71 -69 -73 -55 
-71 -73 -71 -73 -71 -73 -71 -73 -71 -71 
-69 -71 -69 -71 -71 -71 -71 -71 -71 -71 
-69 -69 -69 -69 -71 -71 -69 -69 -71 -73 
-71 -71 -71 -71 -71 -71 -71 -71 -71 -71 
-71 -71 -71 -71 -69 -71 -71 -71 -71 -71 
-71 -69 -71 -71 -73 -69 -71 -71 -73 -71 
-73 -69 -73 -69 -73 -69 -71 -69 -71 -69 
-71 -69 -71 -73 -71 -73 -71 -71 -69 -71 
-71 -71 -69 -73 -71 -71 -71 -73 -71 -71 
