-43 -45 -43 -41 -39 -39 -39 -39 -41 -39 
-39 -39 -39 -39 -39 -39 -41 -41 -41 -41 
-41 -41 -41 -41 -41 -43 -41 -43 -43 -43 
-43 -43 -43 -43 -41 -43 -43 -43 -43 -41 
-41 -41 -39 -41 -41 -39 -39 -39 -39 -39 
-37 -37 -35 -33 -37 -37 -43 -43 -43 -43 
-41 -43 -39 -37 -39 -39 -39 -37 -41 -41 
-41 -41 -41 -41 -37 -41 -41 -41 -43 -43 
-41 -41 -41 -41 -41 -41 -41 -41 -41 -41 
-41 -41 -41 -41 -41 -41 -41 -41 -41 -41 
-41 -41 -41 -41 -41 -41 -41 -41 -41 -41 
-41 -41 -41 -41 -41 -41 -41 -41 -41 -41 
-41 -41 -41 -41 -41 -41 -41 -41 -41 -41 
-41 -43 -41 -41 -41 -41 -41 -41 -41 -41 
-41 -41 -41 -39 -41 -41 -41 -41 -41 -41 
-41 -41 -41 -41 -41 -39 -41 -41 -41 -41 
-41 -41 -41 -41 -41 -41 -41 -41 -41 -41 
-41 -41 -41 -41 -41 -41 -41 -41 -41 -41 
-41 -41 -41 -41 -41 -41 -41 -41 -41 -41 
-41 -39 -41 -43 -41 -41 -41 -41 -41 -43 
-41 -41 -41 -41 -41 -41 -41 -41 -41 -41 
-41 -41 -41 -41 -41 -41 -41 -41 -41 -41 
-41 -41 -41 -39 -41 -41 -41 -41 -41 -41 
-39 -41 -39 -41 -41 -41 -41 -41 -41 -41 
-41 -41 -39 -41 -39 -41 -41 -41 -41 -41 
-41 -43 -39 -41 -41 -41 -41 -41 -41 -41 
-41 -41 -41 -41 -41 -41 -41 -41 -41 -41 
-41 -41 -41 -41 -41 -41 -41 -41 -41 -41 
-41 -41 -41 -41 -41 -41 -41 -91 -41 -41 
-41 -41 -41 -41 -41 -41 -87 -41 -41 -41 
-41 -41 -41 -41 -41 -41 -41 -41 -39 -41 
-41 -41 -41 -41 -41 -41 -41 -39 -41 -41 
-41 -41 -41 -41 -41 -39 -41 -41 -41 -41 
-41 -41 -41 -41 -39 -41 -41 -41 -41 -41 
-41 -41 -41 -41 -41 -41 -41 -41 -91 -41 
-41 -41 -41 -41 -41 -41 -41 -41 -41 -41 
-41 -41 -41 -41 -41 -41 -41 -41 -41 -41 
-41 -41 -41 -41 -41 -41 -41 -41 -41 -39 
-41 -41 -41 -41 -41 -41 -41 -41 -41 -43 
-41 -41 -41 -41 -41 -41 -41 -41 -41 -41 
-41 -41 -41 -41 -41 -41 -41 -41 -41 -41 
-43 -41 -41 -41 -39 -41 -39 -41 -41 -41 
-41 -41 -41 -41 -91 -41 -41 -41 -41 -39 
-41 -41 -41 -41 -41 -41 -39 -41 -41 -41 
-41 -41 -41 -41 -41 -41 -41 -41 -41 -41 
-41 -41 -41 -41 -41 -41 -41 -41 -41 -41 
-41 -43 -41 -39 -41 -41 -41 -41 -43 -39 
-41 -41 -41 -41 -41 -41 -41 -41 -41 -41 
-41 -41 -41 -41 -41 -41 -43 -41 -41 -41 
-41 -41 -41 -41 -41 -41 -41 -41 -41 -41 
-39 -41 -41 -41 -41 -41 -43 -43 -43 -43 
-41 -43 -41 -41 -39 -41 -37 -37 -43 -41 
-39 -39 -39 -39 -39 -39 -37 -37 -37 -39 
-39 -43 -41 -39 -33 -39 -39 -41 -41 -37 
-37 -43 -41 -37 -35 -41 -41 -39 -39 -41 
-39 -43 -43 -43 -43 -41 -39 -41 -39 -37 
-37 -47 -45 -37 -37 -37 -35 -39 -37 -37 
-37 -41 -43 -41 -41 -41 -41 -39 -39 -39 
-39 -39 -39 -39 -39 -39 -39 -39 -39 -37 
-37 -37 -35 -37 -37 -37 -37 -37 -37 -37 
-37 -37 -37 -37 -37 -37 -37 -37 -37 -37 
-37 -39 -39 -37 -37 -37 -39 -37 -39 -39 
-37 -39 -37 -39 -37 -39 -39 -39 -37 -39 
-39 -39 -39 -39 -39 -39 -39 -37 -39 -39 
-39 -39 -39 -39 -41 -39 -39 -39 -39 -39 
-37 -39 -39 -39 -37 -39 -37 -39 -37 -39 
-37 -37 -37 -37 -35 -37 -37 -37 -37 -37 
-37 -37 -37 -37 -37 -37 -37 -37 -37 -37 
-37 -39 -37 -37 -37 -37 -37 -37 -39 -37 
-37 -37 -39 -37 -37 -37 -37 -37 -37 -37 
-37 -35 -33 -37 -37 -37 -37 -35 -37 -35 
-37 -39 -37 -37 -37 -37 -37 -37 -37 -37 
-37 -35 -37 -37 -37 -37 -37 -37 -37 -37 
-37 -35 -37 -37 -37 -37 -37 -37 -37 -37 
-37 -37 -37 -37 -37 -37 -39 -37 -39 -37 
-39 -37 -37 -37 -37 -37 -37 -37 -37 -37 
-35 -37 -37 -39 -37 -37 -37 -37 -37 -37 
-37 -37 -37 -35 -37 -37 -37 -37 -37 -37 
-37 -37 -37 -37 -37 -37 -37 -37 -37 -39 
-37 -37 -37 -39 -37 -37 -37 -37 -37 -37 
-37 -37 -37 -37 -37 -37 -37 -37 -37 -37 
-37 -37 -37 -35 -37 -37 -37 -35 -37 -37 
-37 -37 -37 -37 -37 -37 -37 -37 -37 -37 
-37 -37 -37 -37 -37 -37 -37 -37 -37 -37 
-37 -37 -37 -37 -37 -37 -37 -37 -37 -37 
-37 -37 -37 -37 -37 -37 -37 -37 -37 -37 
-37 -37 -37 -39 -37 -37 -37 -37 -37 -37 
-39 -37 -37 -37 -39 -35 -37 -37 -37 -37 
-37 -37 -37 -37 -37 -37 -37 -37 -37 -37 
-37 -35 -37 -37 -37 -37 -37 -37 -37 -37 
-37 -37 -37 -37 -37 -37 -91 -37 -37 -37 
-37 -37 -37 -37 -39 -37 -37 -37 -39 -37 
-37 -37 -37 -37 -37 -37 -37 -91 -37 -37 
-39 -37 -39 -37 -37 -37 -37 -37 -37 -37 
-37 -37 -39 -37 -37 -37 -37 -37 -37 -37 
-37 -37 -37 -37 -37 -37 -37 -37 -37 -37 
-37 -37 -37 -37 -37 -37 -37 -37 -37 -37 
-37 -37 -37 -37 -37 -37 -37 -37 -37 -39 
-37 -39 -37 -37 -35 -35 -37 -37 -37 -37 
-39 -39 -37 -37 -37 -37 -37 -37 -37 -39 
-37 -37 -37 -37 -37 -37 -37 -37 -39 -37 
-37 -37 -37 -37 -37 -37 -37 -37 -37 -37 
-37 -37 -37 -39 -37 -39 -39 -43 -43 -41 
-39 -41 -39 -39 -39 -37 -35 -37 -37 -39 
-39 -39 -39 -39 -43 -43 -43 -43 -43 -39 
-39 -41 -41 -39 -41 -45 -45 -41 -37 -39 
-39 -43 -43 -39 -41 -41 -41 -41 -41 -39 
-39 -41 -39 -43 -41 -41 -39 -39 -43 -43 
-43 -43 -39 -43 -41 -43 -41 -41 -41 -41 
-41 -41 -41 -41 -43 -45 -41 -41 -41 -43 
-41 -39 -39 -41 -41 -39 -39 -39 -39 -39 
-39 -41 -41 -39 -41 -41 -41 -41 -41 -41 
-43 -41 -39 -41 -41 -41 -41 -41 -41 -41 
-41 -41 -39 -41 -39 -43 -43 -43 -43 -43 
-43 -43 -43 -43 -41 -43 -43 -43 -41 -43 
-41 -41 -41 -41 -41 -43 -41 -43 -41 -43 
-41 -43 -41 -41 -37 -41 -43 -43 -39 -41 
-41 -39 -39 -39 -39 -39 -39 -39 -39 -39 
-39 -39 -37 -37 -37 -37 -37 -37 -35 -37 
-37 -35 -35 -35 -35 -35 -35 -35 -91 -37 
-35 -35 -39 -33 -35 -33 -35 -35 -35 -33 
-35 -35 -37 -35 -37 -35 -37 -37 -37 -37 
-39 -39 -41 -39 -37 -37 -35 -33 -37 -37 
-39 -39 -39 -39 -39 -39 -37 -37 -45 -45 
-41 -41 -41 -41 -37 -39 -37 -35 -43 -43 
-39 -37 -41 -39 -41 -41 -35 -35 -41 -41 
-39 -39 -41 -41 -41 -41 -43 -43 -39 -41 
-41 -41 -41 -39 -39 -39 -39 -39 -39 -41 
-39 -41 -41 -41 -41 -41 -41 -41 -41 -41 
-39 -41 -39 -41 -39 -41 -39 -41 -41 -41 
-41 -41 -41 -41 -41 -41 -41 -41 -41 -41 
-39 -41 -41 -41 -41 -41 -41 -41 -41 -41 
-41 -41 -41 -41 -41 -41 -41 -41 -41 -39 
-41 -41 -41 -41 -41 -41 -41 -41 -41 -41 
-41 -41 -41 -41 -41 -41 -39 -41 -41 -41 
-41 -41 -41 -41 -41 -41 -41 -41 -41 -41 
-41 -41 -41 -41 -39 -41 -39 -41 -41 -41 
-39 -41 -39 -41 -43 -41 -41 -41 -41 -41 
-41 -41 -41 -41 -41 -41 -41 -41 -41 -41 
-41 -41 -41 -41 -41 -41 -41 -41 -41 -41 
-39 -41 -41 -41 -41 -41 -41 -41 -41 -41 
-41 -41 -39 -41 -41 -41 -41 -41 -41 -41 
-41 -41 -41 -41 -41 -41 -41 -41 -41 -41 
-43 -41 -41 -41 -41 -41 -39 -41 -39 -41 
-41 -41 -41 -41 -39 -41 -41 -41 -39 -41 
-41 -41 -39 -41 -41 -41 -39 -41 -41 -41 
-41 -39 -41 -41 -41 -41 -41 -39 -41 -41 
-41 -39 -41 -41 -41 -41 -41 -43 -41 -41 
-41 -41 -41 -41 -41 -41 -41 -41 -41 -41 
-41 -41 -41 -41 -41 -41 -41 -39 -39 -41 
-41 -41 -41 -41 -41 -41 -41 -41 -41 -41 
-39 -41 -39 -41 -41 -41 -41 -41 -41 -41 
-41 -41 -41 -41 -41 -41 -41 -41 -41 -41 
-41 -41 -41 -41 -41 -41 -41 -41 -41 -41 
-41 -41 -41 -41 -41 -39 -41 -39 -39 -41 
-41 -41 -41 -41 -41 -41 -41 -41 -41 -41 
-41 -41 -83 -41 -41 -41 -41 -41 -41 -41 
-41 -41 -41 -41 -41 -41 -41 -39 -41 -41 
-41 -41 -41 -41 -41 -41 -41 -41 -41 -41 
-41 -41 -41 -41 -39 -41 -39 -41 -41 -41 
-41 -41 -43 -41 -39 -41 -41 -41 -39 -41 
-41 -41 -41 -41 -41 -39 -41 -39 -41 -41 
-41 -41 -41 -41 -39 -41 -41 -41 -41 -41 
-41 -41 -41 -41 -41 -41 -41 -41 -41 -39 
-41 -41 -41 -39 -41 -43 -41 -41 -41 -41 
-41 -41 -41 -41 -41 -41 -41 -41 -41 -41 
-41 -41 -41 -41 -41 -41 -41 -41 -41 -41 
-41 -41 -41 -41 -41 -41 -41 -41 -41 -41 
-41 -41 -41 -41 -41 -41 -41 -41 -41 -41 
-41 -41 -41 -39 -41 -41 -41 -41 -41 -43 
-41 -39 -41 -41 -39 -39 -41 -39 -39 -41 
-41 -41 -41 -41 -41 -41 -41 -41 -41 -43 
-41 -41 -41 -41 -41 -41 -41 -41 -39 -41 
-41 -41 -41 -41 -41 -41 -41 -41 -39 -41 
-41 -41 -41 -41 -41 -41 -41 -41 -41 -41 
-41 -41 -41 -39 -41 -41 -41 -41 -41 -41 
-41 -41 -41 -41 -41 -41 -41 -41 -41 -41 
-41 -41 -41 -41 -41 -41 -41 -41 -41 -41 
-41 -41 -41 -41 -41 -41 -41 -41 -41 -41 
-39 -41 -39 -41 -41 -41 -91 -41 -83 -41 
-41 -41 -41 -41 -41 -41 -43 -43 -43 -41 
-41 -41 -43 -43 -41 -39 -39 -39 -45 -45 
-37 -43 -41 -37 -37 -41 -39 -39 -39 -39 
-39 -39 -37 -37 -39 -39 -39 -37 -39 -37 
-39 -39 -39 -41 -41 -39 -43 -43 -41 -43 
-39 -39 -39 -41 -41 -39 -43 -41 -45 -43 
-43 -43 -41 -39 -39 -39 -37 -37 -39 -39 
-39 -41 -41 -39 -41 -41 -43 -43 -45 -47 
-45 -45 -45 -43 -41 -41 -41 -39 -37 -39 
-37 -37 -37 -37 -39 -37 -39 -39 -39 -39 
-41 -39 -41 -39 -41 -39 -41 -39 -41 -39 
-41 -39 -41 -91 -41 -39 -41 -39 -41 -39 
-41 -39 -41 -41 -41 -39 -41 -39 -39 -41 
-39 -39 -39 -39 -39 -41 -39 -41 -41 -41 
-39 -41 -39 -41 -41 -41 -39 -41 -39 -41 
-39 -41 -39 -41 -39 -41 -41 -41 -41 -39 
-41 -41 -41 -39 -41 -41 -41 -41 -39 -41 
-39 -39 -41 -39 -41 -41 -41 -41 -41 -39 
-39 -41 -39 -41 -39 -41 -39 -91 -41 -41 
-39 -41 -39 -41 -41 -41 -39 -39 -41 -39 
-41 -39 -41 -39 -41 -39 -41 -39 -41 -41 
-41 -39 -39 -39 -41 -39 -41 -39 -39 -41 
-39 -41 -39 -39 -39 -41 -39 -39 -37 -39 
-39 -39 -37 -39 -39 -37 -35 -39 -37 -39 
-39 -39 -39 -39 -39 -41 -37 -37 -37 -37 
-35 -37 -35 -37 -37 -35 -37 -37 -35 -37 
-35 -35 -33 -35 -33 -35 -35 -35 -35 -33 
-33 -33 -35 -35 -35 -35 -33 -35 -35 -35 
-35 -35 -35 -35 -35 -35 -35 -35 -37 -35 
-39 -41 -43 -41 -39 -39 -39 -39 -41 -39 
-41 -41 -41 -39 -41 -39 -39 -39 -39 -39 
-41 -41 -39 -39 -41 -41 -39 -39 -43 -43 
-39 -39 -37 -37 -43 -41 -41 -43 -45 -37 
-37 -39 -39 -39 -37 -35 -37 -39 -39 -37 
-35 -37 -37 -37 -37 -37 -35 -35 -33 -35 
-35 -35 -35 -37 -37 -35 -37 -37 -37 -37 
-39 -39 -39 -39 -39 -37 -39 -39 -39 -39 
-39 -37 -39 -39 -39 -39 -39 -39 -37 -37 
-37 -37 -35 -33 -35 -35 -37 -35 -39 -39 
-43 -43 -39 -39 -37 -37 -37 -37 -39 -39 
-41 -41 -39 -39 -41 -41 -39 -41 -41 -41 
-41 -37 -35 -41 -39 -45 -41 -49 -49 -53 
-53 -53 -55 -53 -53 -55 -53 -45 -45 -43 
-41 -41 -39 -39 -37 -39 -39 -39 -41 -39 
-37 -41 -41 -39 -39 -41 -39 -39 -39 -41 
-41 -39 -39 -39 -39 -39 -39 -41 -41 -41 
-43 -43 -43 -43 -47 -45 -45 -45 -49 -49 
-45 -47 -91 -45 -43 -43 -41 -41 -39 -39 
-41 -41 -39 -39 -39 -39 -39 -39 -41 -39 
-41 -39 -37 -37 -43 -43 -39 -39 -39 -39 
-37 -37 -39 -37 -91 -91 -37 -35 -41 -39 
-41 -41 -43 -43 -41 -39 -41 -41 -43 -43 
-41 -41 -41 -41 -41 -41 -41 -41 -41 -41 
-41 -43 -41 -41 -41 -39 -41 -41 -41 -41 
-91 -41 -41 -41 -43 -41 -41 -39 -41 -41 
-41 -39 -41 -81 -41 -39 -41 -39 -41 -41 
-41 -41 -41 -41 -41 -41 -41 -41 -41 -41 
-39 -41 -41 -41 -41 -41 -41 -41 -41 -41 
-41 -41 -39 -41 -41 -41 -41 -41 -41 -41 
-41 -41 -39 -41 -41 -41 -39 -41 -41 -41 
-41 -41 -41 -41 -41 -41 -41 -41 -41 -41 
-41 -41 -41 -41 -41 -41 -39 -41 -41 -41 
-41 -89 -41 -41 -41 -41 -41 -41 -41 -41 
-41 -41 -41 -41 -39 -41 -41 -41 -41 -41 
-41 -41 -41 -41 -41 -41 -41 -41 -41 -41 
-41 -39 -41 -41 -41 -41 -41 -41 -41 -41 
-41 -41 -41 -41 -41 -41 -41 -41 -41 -39 
-41 -41 -41 -41 -41 -41 -41 -41 -41 -41 
-41 -41 -41 -41 -41 -41 -41 -41 -41 -39 
-41 -41 -41 -39 -41 -41 -41 -41 -41 -39 
-41 -41 -41 -39 -41 -41 -41 -41 -41 -41 
-41 -41 -41 -41 -41 -41 -41 -41 -39 -41 
-41 -41 -39 -41 -41 -41 -41 -41 -41 -41 
-41 -39 -41 -41 -41 -41 -41 -39 -41 -41 
-41 -41 -41 -41 -41 -41 -41 -41 -41 -41 
-41 -41 -41 -41 -41 -41 -41 -41 -41 -41 
-41 -41 -41 -41 -41 -41 -41 -89 -41 -41 
-41 -41 -41 -41 -41 -41 -41 -39 -41 -41 
-41 -43 -41 -41 -41 -41 -41 -41 -41 -41 
-41 -41 -41 -41 -41 -41 -41 -41 -41 -41 
-41 -41 -41 -41 -41 -41 -41 -41 -41 -41 
-41 -41 -41 -41 -41 -41 -41 -41 -41 -41 
-41 -41 -41 -41 -41 -41 -41 -41 -41 -41 
-41 -39 -41 -41 -41 -41 -41 -41 -41 -41 
-41 -41 -41 -41 -41 -41 -41 -41 -41 -41 
-41 -41 -41 -41 -39 -41 -41 -41 -41 -41 
-41 -41 -41 -41 -41 -41 -41 -41 -41 -41 
-41 -41 -41 -41 -41 -41 -41 -39 -41 -41 
-41 -41 -41 -41 -41 -41 -41 -41 -41 -39 
-41 -41 -41 -41 -41 -41 -41 -41 -41 -41 
-39 -41 -39 -41 -41 -41 -41 -41 -41 -41 
-41 -41 -39 -41 -41 -41 -39 -41 -41 -41 
-41 -41 -41 -41 -41 -41 -41 -39 -41 -41 
-41 -41 -41 -41 -41 -41 -41 -41 -41 -41 
-39 -41 -41 -41 -41 -41 -41 -41 -39 -41 
-41 -41 -41 -41 -41 -41 -41 -41 -39 -41 
-41 -41 -41 -41 -41 -41 -87 -41 -41 -41 
-39 -41 -41 -41 -41 -41 -41 -41 -43 -41 
-41 -41 -41 -41 -41 -41 -41 -41 -39 -41 
-41 -41 -41 -41 -41 -41 -41 -41 -41 -41 
-41 -41 -41 -41 -41 -41 -41 -39 -41 -41 
-41 -41 -41 -41 -41 -41 -41 -41 -41 -41 
-41 -41 -41 -41 -41 -41 -41 -41 -41 -41 
-41 -41 -41 -41 -41 -41 -41 -41 -41 -41 
-41 -41 -41 -41 -41 -41 -41 -41 -39 -41 
-91 -41 -41 -41 -41 -41 -41 -41 -41 -41 
-41 -41 -41 -41 -41 -41 -41 -41 -41 -41 
-41 -39 -41 -41 -41 -41 -41 -41 -41 -39 
-41 -41 -41 -39 -41 -41 -41 -41 -41 -41 
-41 -41 -41 -41 -41 -41 -41 -41 -41 -41 
-41 -41 -41 -43 -41 -41 -41 -39 -41 -41 
-41 -41 -41 -41 -41 -41 -41 -41 -41 -41 
-41 -41 -41 -41 -41 -41 -39 -41 -41 -41 
-41 -41 -41 -41 -41 -41 -41 -41 -41 -41 
-39 -41 -39 -41 -41 -41 -39 -41 -41 -41 
-41 -41 -41 -41 -41 -41 -41 -41 -41 -41 
-41 -41 -41 -41 -41 -41 -39 -41 -41 -41 
-41 -41 -41 -41 -41 -41 -41 -41 -41 -41 
-41 -41 -41 -41 -41 -41 -41 -41 -41 -41 
-41 -41 -41 -41 -41 -41 -41 -41 -41 -39 
