-69 -69 -71 -71 -71 -69 -71 -71 -71 -69 
-71 -71 -69 -71 -71 -71 -69 -91 -69 -67 
-71 -71 -69 -69 -69 -67 -71 -67 -69 -67 
-71 -67 -69 -67 -71 -69 -71 -69 -71 -69 
-69 -69 -69 -69 -67 -67 -69 -69 -73 -69 
-75 -73 -73 -71 -73 -69 -69 -67 -67 -65 
-63 -65 -65 -69 -65 -67 -67 -65 -65 -63 
-65 -67 -69 -63 -67 -65 -67 -65 -67 -67 
-69 -67 -67 -65 -67 -79 -69 -67 -89 -69 
-67 -65 -73 -71 -75 -75 -65 -67 -65 -69 
-67 -67 -65 -67 -67 -67 -63 -73 -71 -75 
-75 -73 -71 -71 -71 -69 -67 -67 -69 -67 
-69 -67 -69 -69 -67 -69 -69 -67 -47 -71 
-71 -65 -65 -73 -69 -77 -75 -75 -79 -71 
-71 -71 -69 -65 -63 -65 -69 -71 -71 -67 
-63 -65 -65 -77 -71 -69 -77 -73 -69 -69 
-73 -67 -73 -71 -69 -69 -71 -71 -69 -71 
-71 -71 -71 -69 -69 -73 -73 -73 -73 -71 
-73 -71 -75 -73 -71 -77 -73 -71 -73 -75 
-75 -73 -71 -71 -69 -89 -71 -71 -71 -69 
-71 -69 -73 -71 -73 -71 -73 -71 -73 -71 
-73 -87 -73 -71 -73 -71 -73 -71 -73 -69 
-71 -69 -71 -73 -69 -71 -71 -71 -71 -73 
-73 -73 -69 -69 -69 -71 -69 -71 -71 -73 
-73 -73 -73 -73 -71 -71 -73 -71 -75 -71 
-75 -71 -75 -73 -75 -69 -73 -71 -71 -71 
-71 -69 -71 -69 -71 -69 -71 -71 -73 -71 
-71 -69 -69 -69 -69 -73 -69 -71 -69 -73 
-71 -71 -69 -71 -71 -71 -71 -71 -69 -73 
-69 -71 -69 -73 -69 -71 -69 -71 -71 -69 
-71 -69 -73 -71 -73 -69 -73 -69 -71 -69 
-71 -67 -71 -69 -73 -69 -73 -69 -73 -71 
-73 -69 -73 -69 -73 -69 -73 -69 -73 -69 
-71 -71 -71 -71 -73 -71 -71 -69 -73 -69 
-71 -69 -73 -69 -73 -75 -73 -75 -77 -79 
-73 -71 -71 -75 -71 -73 -73 -71 -71 -69 
-71 -71 -73 -73 -73 -73 -73 -71 -73 -73 
-73 -73 -71 -69 -69 -67 -69 -69 -75 -73 
-71 -71 -73 -73 -75 -77 -73 -69 -73 -71 
-69 -73 -71 -67 -65 -73 -73 -71 -69 -77 
-73 -71 -73 -71 -77 -77 -67 -71 -73 -73 
-73 -69 -71 -69 -65 -63 -73 -69 -71 -69 
-71 -69 -73 -73 -71 -67 -65 -63 -67 -65 
-71 -75 -75 -75 -73 -75 -73 -75 -73 -75 
-71 -73 -71 -65 -67 -67 -67 -65 -65 -67 
-63 -63 -75 -71 -67 -63 -71 -71 -67 -91 
-71 -67 -69 -69 -77 -75 -69 -65 -67 -67 
-73 -69 -67 -65 -69 -73 -69 -67 -71 -69 
-91 -91 -69 -67 -47 -47 -75 -73 -73 -71 
-71 -69 -69 -71 -69 -73 -69 -71 -67 -71 
-69 -71 -69 -71 -71 -69 -71 -69 -67 -71 
-69 -71 -69 -71 -69 -73 -73 -73 -71 -75 
-73 -75 -73 -69 -65 -71 -69 -69 -67 -69 
-67 -71 -71 -71 -69 -71 -69 -71 -69 -69 
-69 -65 -63 -65 -67 -67 -67 -67 -69 -69 
-69 -67 -63 -63 -87 -67 -69 -67 -69 -67 
-69 -67 -69 -69 -65 -71 -69 -71 -69 -73 
-85 -71 -73 -73 -73 -67 -71 -71 -75 -73 
-71 -73 -69 -67 -65 -67 -65 -67 -67 -67 
-63 -67 -65 -67 -67 -67 -65 -65 -67 -67 
-67 -69 -67 -71 -67 -69 -69 -71 -67 -69 
-69 -71 -67 -69 -69 -69 -69 -69 -67 -69 
-69 -67 -69 -67 -71 -67 -67 -65 -69 -65 
-67 -65 -67 -65 -67 -65 -65 -67 -67 -65 
-63 -67 -67 -67 -67 -67 -65 -71 -67 -69 
-69 -71 -67 -71 -69 -69 -67 -69 -65 -67 
-67 -65 -67 -67 -67 -67 -69 -67 -67 -65 
-67 -65 -65 -67 -65 -65 -67 -65 -67 -67 
-65 -91 -67 -67 -63 -63 -65 -65 -67 -63 
-69 -67 -71 -69 -71 -67 -71 -67 -69 -67 
-69 -67 -69 -65 -69 -67 -69 -67 -69 -69 
-69 -67 -69 -67 -71 -67 -67 -67 -69 -67 
-69 -67 -71 -71 -69 -69 -69 -67 -69 -67 
-65 -69 -71 -67 -69 -65 -69 -69 -69 -67 
-69 -65 -69 -67 -69 -67 -69 -67 -69 -67 
-69 -65 -67 -91 -71 -69 -71 -67 -71 -69 
-71 -69 -71 -69 -71 -71 -71 -71 -73 -73 
-71 -73 -73 -73 -73 -73 -71 -67 -67 -71 
-73 -73 -71 -73 -73 -71 -73 -71 -73 -71 
-73 -71 -73 -71 -71 -69 -73 -71 -71 -69 
-73 -71 -73 -69 -73 -69 -73 -69 -73 -71 
-73 -71 -73 -71 -73 -69 -73 -71 -73 -69 
-69 -91 -69 -71 -69 -69 -69 -69 -69 -71 
-69 -71 -71 -71 -71 -71 -71 -71 -71 -73 
-71 -73 -73 -73 -73 -73 -73 -73 -73 -73 
-73 -73 -75 -73 -75 -73 -73 -73 -73 -71 
-73 -73 -73 -73 -71 -71 -67 -69 -69 -71 
-69 -69 -69 -69 -69 -69 -69 -69 -69 -67 
-69 -69 -69 -69 -69 -69 -69 -69 -67 -69 
-67 -69 -67 -69 -69 -69 -69 -69 -69 -69 
-69 -69 -67 -67 -69 -69 -69 -69 -69 -67 
-67 -69 -69 -69 -69 -69 -69 -69 -69 -69 
-69 -67 -69 -69 -69 -69 -69 -69 -69 -69 
-67 -69 -69 -69 -67 -69 -69 -69 -69 -69 
-69 -69 -67 -69 -67 -69 -69 -67 -69 -69 
-69 -69 -67 -69 -69 -69 -69 -69 -69 -67 
-69 -69 -83 -63 -63 -61 -61 -61 -63 -61 
-65 -65 -63 -65 -65 -61 -63 -65 -61 -61 
-61 -61 -63 -61 -61 -61 -63 -63 -63 -61 
-63 -63 -63 -63 -65 -61 -65 -63 -63 -65 
-65 -65 -65 -65 -63 -63 -65 -63 -65 -65 
-65 -63 -61 -65 -63 -63 -65 -63 -65 -65 
-65 -63 -65 -63 -63 -63 -65 -65 -65 -63 
-65 -67 -65 -65 -63 -65 -67 -63 -67 -65 
-65 -65 -67 -61 -65 -63 -65 -61 -65 -63 
-65 -63 -65 -65 -63 -67 -65 -65 -63 -65 
-65 -63 -65 -63 -67 -65 -67 -65 -65 -65 
-61 -65 -63 -65 -65 -65 -63 -65 -63 -65 
-63 -65 -65 -65 -65 -61 -67 -63 -65 -63 
-65 -61 -65 -63 -65 -63 -69 -67 -67 -67 
-65 -65 -67 -63 -65 -61 -65 -63 -67 -63 
-63 -59 -61 -59 -61 -61 -63 -63 -61 -67 
-63 -61 -67 -63 -65 -63 -67 -65 -67 -69 
-69 -71 -67 -67 -65 -67 -63 -67 -65 -69 
-65 -67 -65 -69 -67 -65 -69 -67 -69 -65 
-61 -67 -65 -69 -67 -69 -67 -69 -67 -65 
-67 -67 -67 -67 -65 -61 -63 -65 -63 -69 
-65 -71 -67 -67 -65 -67 -63 -61 -61 -85 
-63 -63 -67 -63 -91 -67 -65 -69 -67 -69 
-67 -69 -65 -67 -83 -65 -63 -65 -61 -65 
-63 -65 -63 -65 -63 -69 -63 -69 -65 -67 
-63 -67 -65 -67 -63 -65 -63 -69 -65 -67 
-67 -65 -65 -63 -65 -67 -63 -67 -65 -67 
-61 -67 -67 -67 -67 -65 -67 -65 -67 -63 
-65 -63 -65 -63 -63 -65 -65 -65 -61 -67 
-69 -65 -63 -67 -67 -65 -67 -63 -63 -67 
-67 -65 -67 -67 -65 -67 -67 -65 -63 -63 
-67 -65 -67 -65 -67 -63 -67 -65 -67 -65 
-67 -65 -65 -63 -67 -65 -63 -69 -67 -67 
-65 -69 -63 -67 -63 -67 -63 -65 -65 -65 
-63 -67 -65 -67 -63 -67 -67 -69 -67 -67 
-65 -67 -65 -67 -65 -67 -65 -65 -63 -65 
-63 -61 -65 -65 -65 -63 -65 -63 -67 -63 
-63 -65 -63 -65 -65 -65 -61 -65 -67 -65 
-67 -63 -65 -63 -65 -65 -67 -65 -65 -65 
-65 -63 -67 -65 -65 -63 -65 -61 -65 -65 
-65 -63 -67 -65 -67 -63 -65 -65 -65 -61 
-65 -61 -65 -61 -65 -65 -65 -63 -65 -65 
-65 -61 -61 -67 -65 -69 -65 -69 -63 -69 
-69 -71 -67 -69 -67 -67 -65 -69 -65 -71 
-67 -69 -67 -67 -65 -69 -65 -67 -65 -67 
-65 -65 -61 -67 -67 -65 -69 -69 -69 -65 
-65 -65 -67 -63 -67 -65 -67 -63 -69 -65 
-65 -61 -67 -63 -65 -65 -67 -67 -65 -71 
-69 -71 -69 -69 -69 -65 -65 -75 -67 -69 
-67 -69 -69 -69 -69 -71 -69 -73 -75 -73 
-77 -65 -63 -69 -67 -69 -69 -67 -67 -65 
-71 -67 -65 -63 -67 -67 -67 -65 -67 -67 
-69 -67 -87 -87 -67 -65 -61 -61 -65 -65 
-69 -65 -69 -65 -69 -67 -71 -69 -71 -69 
-65 -63 -65 -63 -71 -67 -71 -69 -65 -65 
-67 -65 -71 -69 -69 -69 -73 -71 -71 -71 
-67 -67 -71 -71 -71 -67 -67 -71 -69 -73 
-71 -69 -67 -69 -71 -63 -73 -69 -67 -67 
-69 -69 -67 -59 -65 -69 -65 -65 -63 -65 
-63 -65 -65 -63 -63 -65 -65 -67 -65 -65 
-63 -65 -63 -65 -67 -87 -67 -67 -67 -67 
-69 -67 -69 -67 -69 -69 -69 -67 -69 -67 
-67 -69 -67 -69 -69 -69 -65 -69 -69 -67 
-67 -67 -67 -67 -69 -67 -69 -67 -67 -67 
-69 -69 -69 -67 -67 -67 -67 -67 -67 -67 
-69 -67 -69 -65 -69 -91 -69 -71 -69 -67 
-69 -61 -67 -69 -69 -65 -71 -71 -71 -71 
-71 -71 -71 -71 -67 -71 -73 -67 -73 -73 
-71 -73 -73 -71 -73 -73 -67 -67 -67 -63 
-67 -67 -67 -65 -67 -63 -67 -67 -67 -65 
-67 -67 -67 -65 -91 -67 -67 -65 -65 -65 
-65 -65 -67 -65 -67 -65 -69 -65 -69 -67 
-69 -67 -71 -67 -71 -69 -71 -67 -71 -67 
-71 -69 -71 -69 -71 -67 -69 -69 -67 -67 
-65 -67 -67 -69 -67 -69 -69 -67 -67 -67 
-65 -89 -75 -73 -75 -73 -71 -67 -67 -67 
-65 -67 -67 -67 -63 -67 -65 -69 -65 -69 
-69 -63 -61 -75 -71 -75 -71 -69 -73 -77 
-75 -73 -75 -71 -73 -75 -73 -73 -63 -75 
-73 -73 -73 -73 -73 -73 -73 -71 -71 -69 
-67 -71 -69 -71 -65 -63 -69 -67 -73 -73 
-67 -67 -69 -69 -69 -71 -75 -75 -73 -69 
-71 -69 -69 -69 -65 -77 -73 -75 -75 -79 
-77 -77 -73 -71 -73 -71 -75 -75 -79 -79 
-79 -79 -79 -77 -75 -77 -77 -79 -77 -77 
-75 -71 -69 -75 -73 -75 -71 -75 -75 -71 
-69 -73 -73 -73 -69 -71 -71 -69 -69 -69 
-71 -65 -65 -71 -73 -71 -73 -71 -73 -69 
-71 -67 -69 -65 -67 -65 -67 -65 -67 -65 
-67 -65 -65 -65 -65 -65 -67 -65 -65 -65 
-65 -65 -65 -67 -69 -69 -71 -69 -71 -73 
-75 -71 -67 -75 -77 -71 -71 -69 -73 -73 
-75 -75 -75 -77 -71 -73 -73 -73 -75 -73 
-73 -75 -71 -71 -73 -73 -69 -71 -65 -91 
-71 -71 -69 -73 -71 -71 -69 -71 -71 -73 
-71 -71 -71 -69 -73 -71 -71 -69 -71 -69 
-71 -77 -75 -73 -71 -71 -67 -73 -71 -73 
-69 -71 -73 -71 -73 -73 -73 -73 -73 -75 
-71 -69 -75 -71 -73 -71 -75 -71 -75 -73 
-71 -69 -73 -71 -73 -71 -55 -55 -77 -73 
-71 -67 -73 -71 -71 -67 -71 -69 -73 -69 
-73 -73 -71 -69 -73 -71 -73 -71 -73 -69 
-73 -69 -89 -73 -69 -73 -69 -73 -71 -73 
-69 -69 -69 -71 -69 -71 -69 -73 -71 -73 
-69 -73 -69 -73 -71 -73 -69 -73 -69 -71 
-71 -73 -69 -73 -71 -71 -69 -71 -69 -73 
-69 -73 -71 -69 -69 -71 -67 -73 -69 -73 
-71 -71 -67 -73 -71 -73 -69 -73 -71 -71 
-69 -73 -69 -71 -69 -73 -91 -73 -71 -69 
-71 -69 -69 -73 -71 -69 -73 -71 -73 -69 
-73 -71 -73 -69 -71 -69 -71 -69 -71 -73 
-71 -73 -69 -73 -69 -73 -67 -71 -69 -71 
-69 -73 -73 -69 -73 -69 -73 -71 -73 -69 
-73 -71 -71 -69 -71 -69 -73 -69 -73 -71 
-73 -71 -73 -69 -73 -71 -71 -69 -71 -73 
-71 -69 -73 -69 -73 -69 -73 -67 -71 -73 
-69 -71 -71 -73 -73 -69 -73 -71 -91 -73 
-69 -73 -69 -73 -71 -71 -69 -73 -69 -73 
-69 -73 -69 -71 -69 -71 -73 -69 -73 -71 
-89 -73 -69 -71 -73 -69 -73 -69 -73 -71 
-71 -69 -71 -69 -69 -73 -69 -73 -71 -71 
-65 -61 -73 -69 -73 -69 -71 -71 -71 -69 
-73 -69 -73 -69 -73 -69 -71 -69 -73 -71 
-71 -71 -73 -73 -69 -73 -71 -73 -69 -73 
-71 -73 -91 -73 -71 -73 -71 -71 -71 -65 
-61 -71 -69 -71 -71 -71 -69 -71 -71 -73 
-69 -73 -71 -73 -71 -73 -69 -73 -69 -69 
-71 -73 -73 -69 -73 -69 -71 -69 -73 -69 
-73 -69 -71 -71 -71 -71 -71 -71 -69 -71 
-69 -65 -61 -71 -69 -71 -69 -71 -91 -73 
-69 -73 -69 -71 -69 -73 -71 -73 -73 -69 
-73 -73 -69 -71 -69 -73 -69 -71 -69 -73 
-69 -71 -69 -73 -71 -73 -69 -71 -71 -71 
-71 -69 -71 -67 -65 -73 -69 -73 -73 -65 
-73 -69 -73 -71 -73 -69 -73 -71 -71 -67 
-73 -69 -73 -71 -73 -69 -71 -71 -73 -71 
-71 -69 -71 -73 -69 -73 -69 -65 -63 -71 
-69 -71 -69 -73 -73 -69 -73 -69 -73 -73 
-73 -69 -73 -71 -71 -71 -73 -69 -73 -71 
-73 -69 -71 -73 -69 -73 -73 -69 -73 -69 
-73 -69 -89 -73 -69 -69 -73 -71 -71 -69 
-73 -71 -71 -69 -69 -73 -69 -73 -69 -73 
-69 -73 -69 -71 -69 -71 -71 -69 -89 -73 
-67 -71 -69 -73 -71 -71 -69 -73 -69 -71 
-69 -71 -69 -71 -71 -73 -69 -71 -71 -73 
-71 -73 -71 -65 -71 -71 -73 -69 -71 -63 
-73 -69 -73 -71 -69 -71 -69 -71 -69 -73 
-69 -73 -69 -71 -71 -73 -71 -73 -71 -73 
-69 -71 -69 -71 -67 -71 -69 -73 -71 -73 
-71 -89 -73 -69 -73 -71 -73 -69 -73 -71 
-71 -69 -73 -71 -71 -69 -71 -69 -69 -67 
-73 -69 -71 -71 -69 -77 -75 -75 -71 -75 
-75 -73 -77 -75 -75 -73 -75 -71 -69 -71 
-67 -73 -69 -73 -71 -73 -71 -75 -73 -73 
-75 -75 -75 -73 -73 -73 -73 -71 -73 -71 
-75 -73 -69 -67 -75 -73 -69 -65 -73 -69 
-69 -69 -73 -69 -71 -67 -71 -71 -73 -71 
-67 -65 -71 -69 -71 -67 -71 -71 -71 -89 
-73 -73 -73 -77 -79 -75 -73 -69 -71 -73 
-73 -71 -71 -73 -71 -67 -67 -69 -69 -73 
-71 -71 -77 -71 -77 -77 -73 -73 -69 -69 
-75 -71 -75 -73 -71 -67 -71 -69 -69 -67 
-69 -69 -65 -69 -67 -69 -67 -67 -65 -67 
-65 -67 -67 -67 -65 -65 -61 -69 -67 -65 
-69 -65 -67 -63 -67 -65 -65 -65 -67 -65 
-67 -63 -65 -63 -63 -59 -67 -65 -67 -65 
-67 -67 -65 -67 -67 -67 -65 -67 -65 -69 
-67 -67 -67 -69 -69 -65 -67 -69 -67 -65 
-67 -65 -63 -69 -67 -69 -69 -71 -69 -67 
-65 -69 -67 -65 -67 -63 -67 -65 -65 -67 
-65 -67 -63 -73 -69 -67 -71 -69 -71 -69 
-71 -69 -77 -71 -75 -73 -73 -69 -71 -69 
-71 -67 -71 -71 -67 -65 -73 -53 -67 -67 
-69 -67 -67 -67 -67 -69 -63 -73 -71 -75 
-71 -73 -71 -73 -75 -73 -71 -75 -73 -75 
-73 -69 -73 -73 -71 -73 -69 -69 -69 -69 
-67 -67 -73 -73 -73 -71 -75 -73 -75 -75 
-71 -71 -69 -65 -73 -71 -69 -71 -65 -65 
-69 -67 -67 -75 -79 -77 -79 -75 -73 -71 
-69 -71 -67 -71 -67 -71 -69 -83 -69 -67 
-69 -67 -71 -71 -73 -71 -67 -63 -71 -67 
-71 -73 -71 -73 -73 -73 -71 -75 -75 -71 
-69 -73 -69 -73 -71 -71 -69 -73 -71 -71 
-69 -73 -71 -69 -73 -73 -75 -73 -73 -71 
-73 -69 -75 -73 -73 -73 -73 -73 -71 -73 
-71 -75 -71 -73 -73 -73 -71 -77 -73 -71 
-69 -69 -71 -69 -65 -91 -71 -69 -71 -69 
-69 -69 -75 -73 -73 -71 -71 -73 -75 -73 
-73 -73 -73 -69 -73 -71 -71 -71 -73 -71 
-71 -69 -71 -69 -71 -69 -73 -69 -73 -71 
-73 -71 -71 -71 -73 -69 -71 -69 -73 -71 
-73 -71 -71 -67 -73 -69 -73 -71 -73 -69 
-71 -69 -71 -71 -71 -71 -71 -69 -71 -71 
-73 -71 -73 -71 -71 -69 -89 -71 -71 -71 
-69 -73 -69 -73 -69 -73 -69 -71 -73 -71 
-67 -73 -71 -71 -69 -73 -71 -71 -69 -73 
-71 -73 -71 -69 -71 -69 -73 -69 -73 -69 
-73 -69 -71 -71 -73 -69 -71 -73 -69 -73 
-69 -73 -71 -71 -69 -71 -73 -71 -71 -73 
-69 -73 -69 -71 -69 -73 -69 -73 -69 -73 
-71 -73 -69 -71 -69 -73 -67 -73 -69 -73 
-71 -71 -69 -71 -69 -73 -71 -67 -73 -71 
-73 -71 -73 -67 -73 -69 -73 -71 -73 -69 
-73 -73 -69 -73 -71 -73 -75 -73 -73 -75 
