-61 -55 -59 -59 -57 -59 -57 -57 -59 -57 
-57 -59 -59 -55 -57 -57 -57 -59 -57 -57 
-57 -57 -59 -59 -57 -57 -57 -57 -57 -59 
-59 -59 -57 -59 -57 -59 -57 -57 -91 -59 
-61 -59 -57 -59 -57 -57 -57 -57 -59 -57 
-57 -59 -57 -59 -57 -57 -57 -59 -59 -59 
-57 -59 -57 -57 -59 -57 -59 -57 -59 -57 
-59 -59 -57 -59 -59 -57 -57 -57 -59 -57 
-59 -57 -59 -57 -59 -57 -59 -61 -57 -57 
-59 -57 -59 -59 -59 -57 -59 -59 -59 -57 
-59 -57 -57 -57 -59 -59 -59 -59 -91 -59 
-57 -59 -59 -57 -57 -59 -57 -59 -57 -53 
-51 -59 -59 -57 -57 -59 -57 -59 -59 -57 
-59 -59 -57 -63 -59 -57 -59 -59 -59 -57 
-59 -59 -59 -59 -59 -57 -59 -59 -59 -57 
-59 -57 -59 -59 -59 -57 -59 -57 -59 -57 
-59 -59 -57 -57 -57 -59 -57 -57 -57 -59 
-57 -57 -59 -59 -57 -59 -59 -59 -57 -59 
-59 -57 -57 -59 -59 -59 -57 -57 -59 -59 
-59 -59 -57 -59 -59 -59 -59 -59 -57 -59 
-57 -59 -59 -57 -59 -59 -57 -57 -57 -57 
-59 -59 -59 -57 -57 -59 -57 -59 -57 -59 
-59 -59 -59 -59 -57 -59 -59 -57 -59 -59 
-57 -57 -57 -59 -59 -59 -57 -59 -57 -59 
-59 -57 -59 -59 -57 -59 -59 -59 -59 -59 
-57 -59 -57 -59 -59 -57 -59 -59 -59 -59 
-57 -59 -57 -59 -59 -59 -59 -57 -59 -59 
-59 -57 -59 -59 -59 -59 -59 -59 -59 -57 
-59 -57 -59 -57 -57 -59 -59 -59 -57 -59 
-57 -59 -59 -59 -57 -59 -57 -59 -57 -59 
-59 -59 -59 -59 -57 -57 -59 -57 -57 -59 
-59 -57 -59 -57 -59 -59 -57 -57 -59 -57 
-59 -57 -91 -59 -59 -59 -57 -59 -57 -59 
-59 -59 -59 -59 -57 -57 -59 -59 -59 -57 
-59 -57 -59 -57 -59 -59 -59 -59 -59 -57 
-59 -59 -59 -61 -57 -57 -59 -59 -59 -57 
-59 -59 -59 -59 -59 -57 -59 -57 -59 -57 
-59 -57 -59 -57 -57 -59 -59 -59 -59 -57 
-59 -59 -57 -57 -59 -59 -59 -59 -59 -59 
-57 -57 -57 -61 -59 -59 -59 -57 -59 -53 
-57 -59 -59 -59 -59 -59 -59 -59 -61 -57 
-57 -59 -57 -57 -57 -59 -59 -57 -57 -59 
-57 -59 -57 -59 -57 -59 -57 -57 -59 -59 
-57 -59 -57 -59 -59 -57 -61 -59 -59 -59 
-57 -59 -59 -59 -59 -57 -59 -59 -59 -53 
-51 -57 -57 -59 -57 -59 -59 -59 -59 -57 
-59 -57 -81 -59 -59 -59 -57 -57 -57 -57 
-59 -59 -59 -57 -57 -59 -59 -59 -57 -59 
-59 -59 -71 -59 -59 -57 -59 -59 -57 -59 
-57 -59 -57 -59 -53 -51 -57 -59 -59 -59 
-59 -59 -59 -57 -59 -57 -59 -59 -59 -57 
-59 -59 -57 -57 -59 -59 -59 -57 -59 -57 
-59 -59 -59 -59 -57 -59 -57 -57 -57 -59 
-59 -59 -59 -59 -59 -57 -59 -59 -57 -59 
-59 -57 -57 -57 -57 -57 -59 -57 -59 -59 
-57 -57 -59 -57 -59 -59 -57 -59 -59 -57 
-59 -59 -59 -57 -59 -57 -57 -57 -59 -57 
-57 -57 -59 -57 -57 -59 -59 -57 -89 -59 
-57 -59 -59 -59 -57 -59 -57 -59 -57 -59 
-59 -57 -57 -59 -59 -59 -59 -59 -57 -59 
-59 -59 -57 -59 -53 -57 -59 -59 -57 -59 
-57 -59 -57 -57 -59 -59 -57 -59 -59 -59 
-59 -59 -57 -59 -59 -59 -59 -59 -57 -59 
-59 -57 -59 -57 -59 -59 -57 -59 -59 -59 
-55 -57 -57 -59 -59 -59 -57 -59 -57 -59 
-57 -59 -57 -57 -57 -59 -57 -59 -59 -59 
-57 -57 -59 -57 -59 -57 -59 -59 -59 -59 
-57 -59 -57 -57 -59 -59 -57 -59 -59 -59 
-57 -59 -59 -57 -59 -59 -59 -59 -59 -59 
-57 -93 -59 -59 -57 -57 -57 -57 -59 -59 
-59 -59 -59 -59 -59 -57 -57 -59 -57 -59 
-59 -57 -59 -59 -59 -59 -59 -59 -57 -59 
-59 -59 -59 -57 -57 -59 -59 -57 -57 -53 
-59 -59 -61 -59 -57 -57 -57 -59 -59 -59 
-57 -57 -59 -59 -57 -59 -57 -59 -59 -59 
-59 -59 -57 -59 -59 -59 -57 -57 -57 -59 
-59 -57 -57 -59 -59 -57 -59 -59 -59 -59 
-59 -57 -59 -57 -59 -59 -59 -59 -59 -57 
-59 -57 -57 -57 -59 -53 -59 -55 -51 -59 
-59 -59 -59 -59 -59 -59 -57 -59 -59 -59 
-59 -59 -57 -59 -59 -59 -59 -57 -59 -59 
-59 -57 -59 -57 -59 -59 -59 -59 -57 -59 
-59 -57 -57 -57 -57 -59 -59 -57 -59 -57 
-59 -59 -57 -59 -53 -51 -53 -53 -53 -53 
-53 -53 -51 -53 -55 -53 -53 -53 -53 -53 
-53 -53 -51 -53 -51 -59 -59 -59 -59 -59 
-57 -59 -59 -57 -59 -59 -59 -59 -59 -59 
-57 -59 -59 -59 -57 -57 -59 -59 -59 -57 
-59 -57 -57 -57 -59 -59 -59 -57 -59 -57 
-57 -57 -57 -57 -57 -57 -59 -59 -59 -59 
-59 -59 -57 -59 -57 -59 -59 -59 -59 -57 
-61 -59 -57 -59 -57 -59 -59 -59 -57 -57 
-59 -59 -57 -57 -57 -57 -59 -59 -59 -59 
-57 -59 -57 -59 -57 -57 -59 -59 -57 -59 
-57 -59 -59 -57 -57 -57 -59 -57 -57 -59 
-59 -59 -57 -57 -59 -57 -59 -57 -59 -59 
-59 -59 -59 -57 -71 -71 -59 -59 -59 -57 
-57 -57 -59 -57 -59 -57 -59 -57 -59 -59 
-59 -59 -59 -57 -59 -59 -59 -59 -57 -59 
-61 -59 -59 -59 -59 -57 -59 -57 -57 -57 
-59 -57 -57 -59 -59 -59 -59 -59 -59 -59 
-59 -59 -53 -59 -57 -59 -59 -59 -59 -59 
-59 -57 -59 -57 -59 -57 -57 -59 -61 -59 
-59 -59 -59 -59 -59 -57 -59 -59 -57 -57 
-59 -59 -59 -59 -59 -59 -59 -59 -59 -59 
-59 -59 -59 -59 -57 -59 -57 -59 -59 -53 
-59 -57 -59 -59 -57 -59 -59 -59 -59 -59 
-59 -59 -59 -59 -59 -91 -59 -57 -59 -59 
-59 -59 -59 -59 -57 -59 -59 -59 -57 -59 
-59 -57 -57 -57 -57 -57 -59 -59 -57 -59 
-59 -59 -59 -59 -59 -59 -57 -57 -59 -57 
-57 -55 -59 -59 -59 -59 -57 -57 -91 -57 
-57 -57 -57 -57 -57 -57 -59 -59 -57 -57 
-59 -59 -59 -59 -59 -57 -59 -59 -59 -59 
-59 -57 -59 -59 -57 -59 -59 -59 -59 -59 
-59 -57 -59 -59 -57 -59 -57 -59 -57 -57 
-57 -57 -59 -59 -57 -59 -57 -57 -55 -57 
-57 -59 -55 -59 -59 -59 -57 -59 -57 -59 
-55 -59 -57 -59 -59 -59 -57 -57 -57 -59 
-57 -57 -59 -85 -57 -57 -57 -57 -59 -57 
-59 -59 -59 -59 -59 -57 -59 -57 -59 -57 
-57 -59 -59 -57 -59 -59 -57 -57 -57 -57 
-57 -59 -59 -59 -57 -57 -59 -59 -57 -57 
-57 -59 -59 -59 -57 -59 -57 -59 -57 -57 
-59 -59 -59 -57 -57 -59 -57 -59 -57 -57 
-57 -57 -57 -59 -57 -59 -57 -59 -57 -59 
-59 -57 -57 -57 -57 -59 -57 -91 -57 -59 
-57 -57 -57 -57 -59 -57 -59 -57 -57 -59 
-55 -57 -55 -59 -59 -57 -57 -59 -59 -57 
-55 -59 -61 -59 -55 -59 -57 -59 -57 -57 
-57 -57 -59 -57 -57 -57 -57 -57 -57 -57 
-59 -57 -57 -57 -59 -57 -57 -57 -57 -57 
-55 -57 -57 -57 -57 -59 -59 -57 -57 -59 
-57 -57 -55 -59 -59 -59 -59 -91 -61 -61 
-59 -57 -59 -57 -57 -57 -59 -59 -59 -59 
-57 -59 -57 -59 -59 -57 -57 -57 -57 -55 
-55 -55 -57 -55 -59 -59 -57 -57 -59 -57 
-57 -59 -57 -59 -61 -61 -57 -57 -59 -57 
-59 -61 -61 -61 -63 -59 -57 -61 -57 -57 
-57 -57 -55 -57 -55 -55 -55 -55 -55 -55 
-55 -57 -57 -59 -61 -59 -59 -57 -57 -57 
-59 -59 -57 -55 -63 -59 -59 -59 -59 -59 
-59 -61 -57 -55 -57 -55 -61 -61 -57 -57 
-63 -63 -57 -57 -59 -57 -61 -59 -59 -61 
-57 -55 -57 -57 -59 -57 -57 -59 -59 -57 
-59 -59 -57 -57 -59 -57 -61 -63 -61 -59 
-63 -61 -61 -61 -59 -59 -57 -57 -61 -61 
-59 -59 -59 -61 -57 -59 -63 -63 -57 -57 
-59 -59 -57 -57 -53 -59 -57 -57 -57 -61 
-59 -57 -55 -57 -57 -59 -57 -59 -57 -59 
-59 -59 -57 -59 -59 -59 -61 -57 -57 -59 
-59 -57 -55 -59 -57 -59 -57 -57 -59 -59 
-59 -61 -59 -59 -57 -59 -57 -59 -59 -57 
-57 -57 -59 -59 -57 -57 -53 -53 -59 -57 
-59 -59 -59 -57 -57 -55 -59 -59 -59 -57 
-57 -57 -59 -61 -57 -59 -57 -55 -57 -91 
-59 -59 -59 -57 -59 -57 -59 -59 -57 -57 
-57 -59 -55 -59 -59 -59 -59 -57 -59 -59 
-57 -59 -57 -59 -57 -59 -59 -57 -57 -59 
-59 -57 -57 -59 -59 -59 -57 -57 -59 -59 
-59 -61 -85 -59 -57 -59 -57 -59 -59 -59 
-57 -57 -57 -57 -59 -57 -57 -55 -57 -57 
-57 -57 -61 -59 -59 -59 -57 -55 -91 -57 
-57 -95 -57 -57 -61 -59 -55 -55 -63 -61 
-57 -57 -55 -57 -55 -59 -57 -59 -57 -59 
-59 -59 -59 -57 -57 -59 -61 -59 -57 -59 
-59 -59 -61 -59 -53 -53 -59 -57 -59 -59 
-59 -57 -57 -57 -61 -61 -61 -59 -61 -59 
-59 -57 -61 -63 -59 -59 -59 -59 -57 -59 
-61 -59 -57 -61 -61 -63 -63 -63 -63 -63 
-63 -61 -61 -61 -59 -59 -57 -55 -61 -59 
-61 -61 -55 -53 -59 -57 -59 -61 -59 -59 
-57 -57 -59 -59 -61 -61 -61 -61 -55 -55 
-55 -55 -53 -51 -51 -53 -53 -53 -53 -57 
-55 -55 -55 -55 -55 -53 -57 -55 -57 -55 
-57 -57 -57 -55 -61 -61 -59 -57 -57 -55 
-55 -55 -57 -55 -61 -63 -55 -55 -55 -53 
-59 -55 -57 -57 -57 -55 -57 -57 -57 -55 
-55 -55 -59 -57 -63 -61 -57 -53 -59 -57 
-59 -59 -59 -57 -59 -59 -63 -63 -57 -55 
-53 -53 -59 -57 -57 -55 -57 -55 -57 -57 
-57 -55 -57 -59 -57 -57 -61 -65 -57 -59 
-57 -57 -57 -59 -59 -57 -59 -57 -57 -55 
-61 -57 -57 -55 -57 -59 -63 -59 -59 -61 
-61 -59 -59 -59 -59 -59 -59 -55 -57 -57 
-57 -57 -57 -59 -57 -57 -57 -91 -55 -59 
-59 -57 -55 -57 -57 -57 -57 -59 -57 -57 
-59 -59 -59 -59 -59 -61 -59 -61 -59 -59 
-59 -59 -59 -59 -57 -55 -59 -59 -59 -59 
-57 -59 -59 -57 -59 -59 -59 -57 -59 -59 
-59 -59 -59 -59 -59 -59 -59 -61 -59 -59 
-59 -61 -59 -61 -59 -59 -59 -59 -59 -77 
-77 -59 -59 -59 -59 -59 -57 -59 -57 -57 
-57 -59 -59 -59 -59 -59 -59 -57 -57 -59 
-59 -59 -59 -59 -55 -55 -57 -57 -57 -57 
-57 -59 -59 -59 -59 -57 -59 -57 -57 -57 
-57 -57 -57 -57 -59 -57 -55 -59 -55 -59 
-59 -57 -59 -57 -57 -57 -59 -59 -59 -57 
-59 -61 -59 -57 -59 -57 -59 -57 -59 -57 
-57 -57 -59 -57 -57 -59 -57 -59 -59 -59 
-59 -59 -61 -59 -61 -59 -59 -59 -57 -59 
-57 -59 -59 -57 -57 -59 -59 -87 -59 -57 
-59 -57 -57 -57 -59 -59 -59 -59 -59 -59 
-59 -57 -57 -91 -57 -91 -57 -57 -57 -59 
-59 -59 -59 -59 -59 -59 -57 -59 -57 -55 
-53 -59 -57 -59 -57 -59 -59 -57 -59 -53 
-59 -59 -57 -57 -57 -59 -59 -57 -57 -59 
-57 -57 -59 -59 -57 -57 -59 -59 -57 -59 
-59 -59 -57 -57 -59 -59 -59 -59 -57 -59 
-59 -57 -59 -59 -57 -59 -57 -59 -59 -59 
-57 -59 -59 -59 -57 -59 -59 -59 -59 -57 
-63 -63 -59 -59 -59 -57 -59 -59 -59 -57 
-59 -59 -57 -59 -59 -59 -59 -59 -59 -59 
-59 -59 -59 -59 -59 -57 -59 -57 -59 -61 
-59 -59 -59 -59 -57 -57 -59 -59 -59 -59 
-59 -59 -59 -59 -57 -57 -57 -59 -59 -59 
-59 -59 -59 -59 -59 -59 -59 -59 -57 -57 
-59 -59 -59 -59 -59 -59 -59 -59 -57 -59 
-59 -59 -59 -59 -59 -59 -57 -59 -57 -59 
-59 -59 -57 -59 -59 -57 -57 -59 -57 -59 
-59 -57 -59 -57 -57 -59 -57 -57 -59 -55 
-59 -59 -57 -59 -59 -59 -59 -57 -57 -57 
-57 -59 -59 -57 -57 -59 -59 -57 -59 -59 
-57 -57 -57 -59 -59 -57 -57 -59 -59 -59 
-59 -57 -59 -59 -57 -59 -59 -59 -59 -59 
-59 -57 -59 -57 -57 -57 -57 -59 -57 -59 
-59 -59 -59 -59 -59 -59 -57 -59 -57 -57 
-59 -57 -59 -57 -53 -51 -59 -57 -57 -55 
-59 -57 -59 -59 -57 -57 -57 -57 -59 -59 
-57 -59 -57 -59 -57 -59 -59 -89 -59 -57 
-57 -57 -59 -59 -57 -59 -91 -59 -57 -59 
-57 -59 -57 -57 -59 -57 -57 -57 -59 -59 
-59 -59 -57 -59 -59 -59 -59 -57 -57 -59 
-57 -59 -57 -59 -57 -59 -59 -59 -59 -59 
-61 -57 -59 -59 -57 -59 -59 -59 -61 -59 
-57 -57 -57 -59 -59 -59 -57 -59 -57 -59 
-57 -59 -59 -59 -57 -59 -59 -59 -57 -57 
-57 -59 -59 -59 -59 -59 -57 -57 -59 -57 
-59 -57 -57 -57 -59 -59 -59 -57 -59 -59 
-59 -59 -59 -59 -59 -57 -57 -57 -57 -57 
-59 -57 -57 -57 -57 -59 -59 -59 -55 -57 
-59 -59 -57 -59 -57 -59 -59 -59 -57 -57 
-59 -57 -55 -59 -57 -59 -59 -59 -57 -57 
-57 -57 -57 -59 -57 -59 -57 -59 -57 -59 
-57 -59 -59 -57 -57 -57 -57 -59 -59 -59 
-59 -59 -59 -59 -57 -59 -59 -59 -59 -59 
-57 -53 -57 -59 -57 -57 -59 -59 -57 -59 
-59 -59 -59 -57 -59 -59 -59 -59 -57 -59 
-57 -59 -59 -57 -57 -57 -57 -59 -59 -59 
-59 -59 -59 -59 -59 -53 -51 -57 -59 -59 
-59 -57 -59 -59 -59 -59 -57 -57 -57 -91 
-59 -57 -59 -59 -57 -59 -59 -59 -57 -59 
-59 -57 -57 -59 -59 -57 -59 -59 -57 -59 
-57 -59 -59 -59 -59 -57 -57 -59 -59 -59 
-87 -59 -57 -59 -57 -59 -57 -59 -59 -59 
-57 -59 -57 -59 -57 -59 -59 -59 -57 -59 
-57 -59 -59 -59 -57 -89 -89 -57 -59 -57 
-59 -59 -57 -59 -59 -59 -55 -57 -57 -57 
-57 -59 -57 -57 -59 -59 -57 -59 -57 -59 
-61 -59 -59 -59 -57 -59 -59 -59 -59 -59 
-53 -51 -59 -57 -59 -59 -57 -59 -59 -59 
-59 -59 -59 -59 -59 -57 -59 -57 -59 -57 
-57 -59 -57 -59 -57 -57 -59 -59 -59 -57 
-57 -85 -59 -59 -59 -59 -59 -57 -59 -57 
-59 -59 -61 -53 -51 -59 -57 -59 -59 -59 
-59 -57 -59 -57 -57 -59 -59 -59 -57 -59 
-59 -59 -57 -59 -59 -57 -57 -59 -59 -59 
-59 -57 -57 -57 -59 -57 -59 -57 -57 -57 
-57 -57 -59 -57 -59 -57 -57 -59 -57 -59 
-57 -59 -57 -53 -49 -57 -55 -57 -55 -59 
-57 -57 -57 -57 -57 -55 -59 -57 -59 -59 
-57 -57 -57 -59 -57 -57 -57 -57 -59 -57 
-59 -59 -57 -59 -59 -55 -57 -59 -57 -57 
-59 -59 -57 -57 -59 -57 -59 -57 -59 -59 
-59 -57 -59 -59 -55 -53 -57 -59 -57 -57 
-57 -57 -57 -57 -59 -57 -61 -59 -59 -59 
-57 -59 -57 -57 -57 -59 -59 -59 -57 -59 
-59 -59 -59 -59 -59 -57 -57 -57 -59 -57 
-59 -57 -57 -57 -59 -57 -59 -59 -59 -55 
-59 -57 -57 -57 -59 -59 -57 -57 -57 -57 
-59 -57 -57 -57 -57 -57 -57 -57 -57 -59 
-57 -59 -59 -57 -59 -59 -57 -59 -57 -59 
-59 -61 -59 -57 -59 -59 -59 -57 -59 -59 
-59 -59 -57 -57 -57 -57 -59 -57 -61 -59 
-59 -57 -57 -59 -59 -59 -57 -57 -53 -55 
-91 -61 -61 -59 -59 -57 -59 -59 -61 -61 
-59 -57 -61 -61 -59 -61 -59 -63 -59 -59 
-59 -57 -59 -57 -55 -57 -59 -57 -61 -61 
-55 -55 -59 -57 -61 -67 -57 -55 -53 -53 
-53 -53 -53 -59 -59 -59 -61 -61 -61 -57 
-57 -67 -71 -61 -61 -63 -65 -61 -63 -63 
-67 -63 -67 -61 -65 -61 -65 -61 -59 -61 
-59 -63 -65 -65 -59 -61 -59 -57 -57 -55 
-55 -55 -61 -63 -63 -65 -63 -67 -59 -61 
-59 -57 -61 -63 -59 -59 -53 -53 -57 -59 
-53 -59 -61 -55 -55 -57 -57 -57 -57 -59 
-59 -57 -57 -57 -53 -57 -55 -57 -57 -57 
-57 -59 -57 -63 -65 -59 -59 -55 -55 -57 
-57 -57 -59 -61 -63 -63 -65 -59 -59 -63 
-61 -57 -55 -63 -59 -59 -59 -57 -63 -63 
