-47 -47 -47 -47 -47 -49 -47 -49 -49 -49 
-47 -49 -49 -49 -49 -49 -49 -47 -49 -49 
-49 -47 -49 -49 -47 -49 -47 -49 -49 -47 
-49 -47 -47 -47 -47 -47 -49 -47 -47 -47 
-49 -49 -47 -47 -47 -47 -47 -47 -47 -49 
-49 -49 -49 -47 -49 -47 -49 -47 -47 -47 
-47 -47 -47 -49 -49 -47 -49 -47 -47 -49 
-49 -49 -49 -47 -49 -49 -47 -47 -47 -47 
-49 -47 -49 -47 -49 -47 -49 -47 -47 -47 
-47 -49 -49 -49 -47 -49 -87 -47 -49 -49 
-49 -49 -49 -47 -49 -49 -49 -49 -49 -47 
-49 -49 -49 -49 -49 -49 -49 -47 -49 -53 
-55 -47 -49 -49 -49 -47 -47 -47 -47 -47 
-47 -47 -49 -47 -49 -47 -49 -49 -47 -47 
-47 -47 -47 -49 -47 -49 -47 -47 -49 -49 
-47 -49 -49 -47 -47 -49 -47 -49 -47 -47 
-47 -47 -49 -49 -47 -49 -47 -47 -47 -49 
-49 -47 -47 -49 -47 -49 -49 -49 -49 -47 
-47 -47 -49 -47 -49 -49 -49 -47 -47 -47 
-47 -49 -49 -47 -49 -49 -49 -47 -47 -49 
-49 -49 -49 -49 -49 -49 -49 -49 -49 -47 
-49 -49 -49 -47 -49 -49 -47 -49 -49 -49 
-47 -47 -49 -49 -49 -49 -49 -47 -47 -47 
-49 -47 -49 -49 -49 -49 -47 -47 -47 -49 
-49 -49 -47 -49 -47 -49 -69 -69 -49 -47 
-49 -47 -49 -49 -47 -49 -47 -47 -47 -49 
-49 -47 -49 -47 -49 -49 -47 -49 -49 -49 
-47 -47 -47 -49 -89 -47 -49 -49 -91 -47 
-49 -49 -49 -49 -49 -49 -85 -49 -49 -49 
-47 -49 -49 -49 -47 -49 -47 -47 -87 -47 
-49 -47 -49 -47 -49 -49 -47 -47 -49 -47 
-47 -49 -47 -47 -49 -49 -49 -49 -49 -47 
-47 -47 -47 -47 -49 -49 -47 -49 -49 -49 
-49 -47 -49 -49 -49 -47 -47 -49 -47 -49 
-47 -47 -47 -47 -49 -49 -47 -49 -49 -49 
-49 -91 -49 -49 -49 -49 -49 -49 -47 -49 
-47 -91 -49 -49 -47 -47 -49 -49 -47 -49 
-49 -49 -47 -47 -47 -49 -49 -47 -49 -49 
-47 -49 -49 -43 -49 -49 -47 -47 -49 -49 
-47 -49 -49 -49 -49 -49 -49 -49 -49 -47 
-47 -49 -47 -49 -49 -47 -47 -47 -49 -49 
-47 -49 -47 -49 -49 -49 -49 -49 -47 -47 
-49 -49 -47 -49 -49 -49 -49 -49 -53 -55 
-47 -49 -49 -47 -47 -49 -47 -47 -47 -49 
-47 -49 -47 -49 -49 -49 -47 -47 -49 -49 
-49 -49 -49 -49 -49 -49 -49 -47 -49 -49 
-49 -49 -49 -47 -49 -53 -53 -47 -47 -49 
-49 -49 -49 -49 -49 -47 -47 -47 -49 -49 
-47 -47 -49 -47 -47 -49 -47 -47 -47 -49 
-49 -47 -47 -47 -49 -49 -49 -49 -47 -47 
-47 -49 -47 -47 -47 -49 -47 -47 -49 -47 
-47 -49 -47 -49 -49 -47 -47 -47 -47 -47 
-49 -49 -49 -47 -49 -47 -49 -49 -47 -47 
-49 -49 -47 -49 -49 -47 -49 -47 -47 -49 
-47 -47 -49 -47 -49 -49 -49 -47 -49 -47 
-49 -49 -47 -47 -49 -89 -47 -49 -49 -49 
-47 -49 -49 -47 -49 -47 -47 -49 -49 -49 
-49 -47 -43 -47 -47 -49 -49 -47 -49 -49 
-49 -49 -47 -49 -47 -47 -49 -49 -49 -47 
-49 -49 -49 -49 -49 -47 -47 -49 -91 -47 
-49 -47 -49 -49 -47 -49 -47 -49 -49 -49 
-49 -49 -49 -49 -49 -49 -49 -47 -49 -47 
-47 -49 -47 -47 -49 -49 -49 -47 -49 -49 
-49 -49 -49 -49 -47 -49 -49 -49 -49 -51 
-49 -49 -49 -49 -49 -47 -49 -47 -47 -49 
-49 -47 -47 -49 -49 -49 -47 -47 -47 -49 
-49 -49 -47 -47 -47 -47 -47 -47 -49 -47 
-49 -49 -49 -49 -49 -49 -47 -47 -47 -49 
-47 -47 -49 -49 -49 -49 -91 -49 -49 -49 
-49 -47 -49 -47 -49 -49 -47 -47 -47 -47 
-49 -49 -47 -47 -49 -47 -49 -49 -47 -49 
-49 -49 -47 -49 -49 -49 -49 -49 -49 -49 
-49 -47 -49 -49 -49 -43 -49 -55 -47 -49 
-49 -47 -47 -49 -49 -49 -47 -49 -47 -49 
-49 -49 -47 -49 -47 -49 -49 -49 -49 -49 
-47 -49 -47 -49 -49 -49 -49 -49 -49 -49 
-49 -49 -47 -49 -47 -49 -49 -47 -49 -49 
-71 -51 -53 -51 -53 -51 -53 -51 -53 -51 
-53 -51 -51 -51 -53 -51 -53 -51 -53 -51 
-53 -51 -53 -49 -89 -49 -47 -49 -47 -49 
-47 -49 -49 -49 -49 -49 -47 -49 -47 -49 
-49 -49 -47 -49 -49 -47 -49 -49 -47 -49 
-49 -49 -47 -49 -47 -49 -49 -49 -49 -49 
-47 -47 -49 -47 -47 -49 -49 -49 -49 -47 
-47 -49 -49 -49 -49 -49 -47 -49 -47 -49 
-49 -51 -47 -49 -47 -49 -47 -49 -49 -47 
-47 -47 -47 -47 -47 -49 -49 -47 -47 -49 
-49 -49 -49 -49 -49 -47 -49 -49 -47 -49 
-51 -49 -49 -91 -49 -47 -49 -47 -49 -49 
-47 -49 -47 -47 -47 -49 -49 -47 -49 -49 
-49 -49 -49 -49 -49 -49 -49 -49 -47 -49 
-49 -49 -47 -49 -49 -47 -49 -47 -47 -47 
-47 -49 -49 -47 -49 -49 -47 -47 -47 -49 
-47 -49 -47 -49 -49 -49 -47 -49 -49 -49 
-47 -49 -49 -49 -47 -47 -47 -49 -47 -47 
-49 -47 -49 -47 -47 -49 -49 -47 -49 -41 
-47 -49 -47 -49 -47 -49 -49 -49 -47 -49 
-49 -47 -47 -47 -47 -49 -47 -49 -47 -47 
-49 -49 -49 -51 -49 -47 -47 -47 -49 -49 
-47 -47 -49 -47 -45 -47 -47 -49 -47 -49 
-47 -49 -47 -49 -47 -47 -49 -49 -47 -49 
-47 -49 -47 -47 -49 -47 -49 -49 -47 -47 
-47 -47 -49 -49 -49 -47 -49 -47 -47 -47 
-47 -49 -49 -49 -49 -49 -47 -47 -47 -49 
-49 -47 -47 -49 -49 -49 -49 -47 -49 -49 
-49 -49 -49 -49 -49 -47 -49 -49 -47 -47 
-47 -49 -47 -47 -49 -49 -49 -49 -47 -47 
-47 -47 -47 -47 -49 -47 -47 -47 -47 -49 
-47 -49 -49 -49 -47 -49 -49 -47 -47 -47 
-47 -49 -49 -49 -47 -47 -47 -47 -47 -51 
-47 -49 -49 -49 -95 -49 -47 -49 -49 -49 
-49 -47 -49 -47 -49 -49 -49 -47 -49 -47 
-49 -47 -47 -47 -47 -47 -49 -47 -49 -47 
-47 -49 -49 -47 -49 -49 -49 -49 -49 -49 
-49 -47 -47 -47 -49 -47 -47 -49 -49 -49 
-49 -49 -49 -49 -49 -49 -49 -49 -49 -49 
-91 -49 -49 -49 -43 -49 -49 -49 -49 -47 
-49 -49 -49 -47 -47 -49 -49 -49 -49 -49 
-47 -47 -47 -49 -47 -47 -47 -49 -47 -47 
-47 -47 -49 -49 -49 -49 -49 -49 -49 -49 
-49 -49 -49 -49 -47 -49 -49 -49 -49 -49 
-49 -47 -47 -47 -49 -47 -47 -45 -47 -47 
-49 -49 -47 -49 -47 -47 -47 -47 -49 -47 
-49 -47 -47 -47 -49 -49 -47 -49 -49 -49 
-47 -47 -49 -49 -49 -49 -49 -49 -49 -49 
-49 -49 -47 -49 -49 -49 -49 -49 -47 -49 
-49 -49 -47 -49 -47 -49 -47 -49 -49 -49 
-47 -49 -47 -49 -47 -49 -49 -47 -47 -47 
-47 -47 -47 -47 -49 -49 -49 -47 -47 -47 
-47 -49 -47 -47 -49 -49 -49 -45 -47 -47 
-47 -47 -47 -47 -49 -47 -47 -47 -49 -47 
-47 -49 -51 -49 -49 -49 -51 -47 -47 -47 
-47 -45 -47 -47 -47 -47 -47 -47 -49 -47 
-47 -49 -49 -49 -47 -49 -49 -49 -49 -49 
-49 -49 -49 -49 -49 -49 -49 -49 -49 -49 
-51 -47 -49 -49 -51 -49 -49 -49 -49 -49 
-49 -47 -49 -49 -49 -49 -49 -49 -49 -47 
-49 -49 -51 -49 -49 -47 -49 -49 -49 -49 
-51 -49 -49 -49 -47 -47 -49 -47 -49 -47 
-47 -47 -55 -47 -47 -49 -49 -47 -49 -49 
-49 -47 -47 -49 -49 -49 -47 -49 -49 -47 
-47 -49 -51 -47 -47 -47 -49 -49 -49 -49 
-49 -49 -49 -49 -47 -49 -49 -49 -49 -49 
-49 -47 -47 -49 -49 -49 -47 -47 -49 -49 
-53 -55 -47 -47 -49 -49 -47 -47 -47 -49 
-47 -47 -49 -49 -49 -49 -47 -49 -49 -47 
-49 -47 -91 -47 -47 -49 -47 -49 -49 -47 
-49 -49 -49 -49 -47 -47 -47 -47 -49 -49 
-49 -47 -49 -49 -49 -49 -49 -47 -49 -49 
-49 -47 -49 -49 -49 -47 -49 -49 -49 -49 
-49 -49 -49 -49 -49 -49 -47 -47 -47 -47 
-49 -49 -49 -47 -49 -49 -49 -49 -49 -49 
-47 -49 -49 -47 -47 -47 -47 -49 -49 -47 
-49 -49 -47 -49 -47 -49 -49 -47 -47 -47 
-49 -47 -49 -49 -49 -49 -47 -49 -49 -49 
-47 -49 -47 -49 -49 -47 -47 -49 -47 -47 
-47 -89 -49 -47 -53 -55 -49 -47 -49 -47 
-49 -49 -49 -47 -49 -49 -51 -47 -47 -47 
-49 -49 -49 -47 -49 -47 -49 -49 -51 -49 
-49 -49 -49 -49 -49 -49 -47 -49 -49 -49 
-49 -49 -47 -49 -47 -49 -53 -53 -47 -47 
-49 -49 -47 -49 -49 -49 -49 -49 -49 -49 
-49 -49 -49 -49 -49 -49 -49 -49 -49 -51 
-49 -47 -49 -49 -49 -49 -49 -49 -51 -51 
-49 -49 -47 -47 -49 -49 -51 -47 -47 -47 
-49 -49 -49 -47 -49 -47 -47 -45 -45 -47 
-45 -47 -45 -47 -47 -45 -47 -51 -51 -51 
-51 -49 -53 -55 -57 -49 -49 -51 -49 -51 
-47 -47 -49 -49 -47 -47 -47 -49 -49 -47 
-47 -49 -51 -45 -51 -51 -49 -47 -47 -45 
-45 -49 -49 -47 -47 -49 -49 -47 -45 -49 
-49 -47 -47 -47 -49 -85 -49 -49 -49 -49 
-47 -49 -49 -49 -47 -47 -49 -47 -47 -47 
-47 -49 -47 -47 -47 -47 -47 -49 -47 -45 
-47 -45 -47 -47 -45 -47 -47 -49 -47 -47 
-47 -47 -49 -49 -49 -49 -47 -49 -47 -47 
-47 -47 -49 -49 -51 -49 -49 -49 -49 -47 
-49 -49 -49 -47 -47 -49 -49 -49 -47 -49 
-47 -51 -47 -49 -47 -49 -47 -51 -47 -47 
-47 -49 -51 -49 -51 -49 -47 -49 -49 -49 
-91 -47 -49 -49 -49 -81 -49 -49 -47 -47 
-49 -49 -89 -49 -47 -49 -47 -49 -45 -47 
-49 -47 -47 -47 -49 -47 -49 -47 -47 -47 
-47 -47 -91 -49 -51 -49 -49 -47 -49 -47 
-47 -47 -91 -49 -49 -49 -49 -47 -49 -47 
-49 -49 -49 -49 -49 -51 -49 -47 -49 -49 
-49 -47 -49 -49 -49 -49 -49 -47 -49 -49 
-47 -49 -49 -47 -47 -47 -47 -47 -49 -49 
-47 -49 -49 -47 -49 -49 -49 -49 -49 -47 
-49 -49 -49 -47 -47 -49 -49 -49 -49 -47 
-49 -47 -47 -49 -43 -49 -49 -47 -47 -47 
-49 -49 -47 -47 -47 -49 -49 -47 -49 -47 
-49 -49 -47 -49 -49 -49 -47 -49 -49 -49 
-51 -47 -49 -49 -49 -49 -49 -47 -91 -55 
-49 -49 -47 -49 -49 -49 -47 -47 -49 -49 
-47 -49 -47 -49 -49 -49 -49 -49 -49 -47 
-49 -49 -47 -47 -47 -49 -47 -49 -49 -49 
-51 -49 -47 -47 -49 -49 -47 -49 -49 -49 
-49 -49 -49 -49 -47 -49 -49 -49 -47 -49 
-47 -47 -49 -47 -49 -49 -47 -49 -47 -49 
-47 -49 -49 -49 -49 -49 -49 -47 -49 -49 
-49 -49 -51 -49 -49 -49 -49 -49 -49 -49 
-49 -49 -49 -49 -49 -49 -49 -49 -49 -47 
-49 -49 -49 -47 -49 -47 -47 -47 -49 -47 
-49 -49 -49 -49 -49 -49 -49 -49 -47 -49 
-49 -47 -49 -47 -49 -47 -47 -45 -49 -47 
-49 -49 -49 -49 -49 -47 -47 -47 -49 -47 
-49 -47 -49 -49 -47 -49 -47 -49 -47 -49 
-49 -49 -49 -49 -49 -49 -49 -47 -49 -91 
-49 -47 -47 -47 -49 -49 -47 -47 -47 -47 
-49 -49 -49 -47 -47 -47 -49 -49 -89 -51 
-53 -47 -47 -47 -49 -49 -47 -51 -47 -49 
-49 -49 -49 -47 -47 -49 -47 -49 -47 -49 
-47 -47 -49 -47 -49 -49 -47 -49 -49 -47 
-49 -47 -47 -47 -47 -49 -49 -49 -47 -47 
-47 -49 -47 -47 -49 -47 -47 -49 -47 -49 
-49 -49 -49 -49 -49 -49 -89 -49 -47 -49 
-47 -49 -47 -47 -47 -49 -47 -49 -49 -47 
-49 -49 -49 -49 -47 -49 -47 -47 -49 -49 
-49 -47 -47 -49 -49 -49 -49 -49 -47 -47 
-49 -47 -47 -49 -47 -47 -47 -47 -49 -49 
-47 -49 -49 -47 -47 -47 -49 -49 -47 -47 
-47 -49 -49 -91 -49 -49 -49 -49 -49 -47 
-47 -47 -49 -51 -49 -49 -49 -49 -49 -49 
-49 -49 -49 -49 -49 -49 -49 -49 -47 -49 
-47 -47 -49 -49 -49 -51 -49 -49 -49 -51 
-49 -49 -49 -49 -49 -49 -51 -49 -49 -49 
-49 -49 -49 -49 -49 -49 -49 -51 -49 -49 
-49 -49 -47 -47 -47 -49 -49 -49 -49 -47 
-49 -49 -47 -49 -89 -43 -49 -49 -47 -49 
-47 -49 -49 -47 -49 -47 -49 -49 -49 -49 
-49 -49 -49 -47 -47 -47 -53 -53 -49 -49 
-49 -47 -47 -47 -49 -49 -49 -49 -49 -49 
-47 -47 -47 -47 -49 -49 -47 -49 -47 -49 
-49 -49 -49 -49 -49 -87 -51 -51 -45 -49 
-49 -47 -51 -47 -49 -47 -47 -49 -49 -49 
-49 -47 -47 -49 -47 -49 -47 -49 -49 -47 
-47 -47 -49 -49 -47 -49 -47 -47 -47 -41 
-47 -49 -47 -49 -47 -47 -47 -49 -49 -49 
-49 -49 -49 -49 -49 -47 -49 -47 -49 -49 
-47 -47 -49 -49 -47 -49 -53 -55 -47 -49 
-47 -49 -47 -49 -47 -49 -49 -49 -49 -49 
-49 -49 -47 -49 -49 -47 -47 -47 -49 -49 
-49 -49 -49 -49 -47 -47 -49 -49 -47 -49 
-49 -49 -49 -49 -49 -47 -47 -49 -53 -55 
-49 -49 -47 -47 -47 -49 -49 -47 -49 -51 
-49 -47 -49 -49 -47 -47 -49 -49 -49 -49 
-49 -47 -47 -47 -49 -47 -47 -47 -49 -47 
-47 -47 -47 -49 -53 -53 -49 -47 -49 -47 
-47 -47 -47 -47 -47 -47 -47 -47 -47 -47 
-47 -91 -91 -49 -51 -49 -47 -49 -49 -47 
-49 -51 -49 -49 -49 -47 -49 -47 -47 -47 
-49 -47 -47 -49 -49 -49 -49 -47 -47 -43 
-49 -47 -47 -47 -49 -47 -47 -47 -47 -47 
-49 -47 -47 -49 -49 -49 -47 -47 -47 -47 
-47 -49 -91 -49 -47 -49 -47 -49 -47 -47 
-47 -47 -47 -47 -47 -49 -47 -47 -47 -47 
-47 -47 -47 -47 -49 -49 -49 -47 -47 -47 
-49 -49 -47 -47 -47 -47 -49 -47 -47 -49 
-47 -47 -47 -49 -49 -47 -49 -47 -49 -47 
-49 -51 -51 -47 -47 -91 -51 -49 -47 -49 
-49 -49 -51 -49 -47 -49 -47 -49 -49 -47 
-47 -47 -49 -47 -49 -51 -49 -49 -49 -49 
-49 -49 -47 -49 -49 -49 -49 -49 -51 -47 
-49 -47 -49 -49 -47 -47 -47 -47 -47 -47 
-49 -47 -49 -49 -49 -49 -47 -47 -49 -49 
-49 -49 -49 -47 -47 -49 -49 -47 -47 -47 
-49 -47 -47 -47 -47 -49 -49 -49 -49 -49 
-49 -47 -49 -49 -49 -49 -49 -49 -47 -49 
-49 -49 -49 -49 -47 -47 -49 -49 -49 -49 
-47 -49 -49 -49 -47 -49 -49 -49 -47 -47 
-47 -49 -47 -49 -49 -49 -47 -49 -47 -49 
-49 -49 -51 -47 -49 -49 -49 -49 -49 -47 
-49 -49 -47 -47 -49 -49 -49 -49 -47 -49 
-47 -47 -49 -83 -49 -49 -49 -49 -49 -49 
-49 -51 -47 -49 -47 -49 -47 -49 -47 -49 
-49 -47 -47 -49 -49 -47 -47 -47 -49 -47 
-49 -49 -49 -49 -49 -49 -49 -49 -49 -49 
-49 -49 -49 -49 -49 -49 -49 -47 -49 -47 
-49 -47 -47 -47 -49 -47 -49 -47 -49 -49 
-49 -49 -49 -49 -49 -49 -49 -49 -49 -49 
-49 -49 -47 -49 -47 -49 -49 -49 -47 -49 
-47 -47 -49 -47 -47 -49 -49 -47 -49 -49 
-49 -49 -47 -47 -49 -47 -49 -49 -49 -49 
-49 -49 -49 -49 -47 -47 -49 -49 -49 -47 
-47 -49 -49 -47 -47 -49 -47 -47 -47 -49 
-49 -49 -49 -49 -49 -49 -47 -49 -49 -49 
-49 -49 -47 -49 -49 -49 -49 -49 -49 -47 
-47 -49 -49 -49 -49 -49 -49 -49 -47 -49 
-47 -47 -47 -49 -51 -47 -47 -47 -49 -49 
-49 -49 -49 -49 -49 -49 -47 -49 -49 -43 
-49 -49 -51 -49 -49 -47 -47 -47 -49 -47 
-49 -49 -49 -49 -47 -47 -47 -49 -49 -49 
-49 -49 -49 -89 -47 -49 -47 -47 -49 -49 
-47 -47 -49 -91 -49 -49 -49 -49 -49 -47 
-49 -89 -49 -47 -49 -49 -49 -47 -49 -49 
-49 -49 -49 -49 -47 -49 -49 -49 -47 -49 
-49 -49 -49 -47 -47 -47 -47 -49 -49 -51 
-49 -49 -49 -49 -49 -49 -51 -49 -49 -51 
-87 -47 -49 -47 -49 -47 -49 -49 -49 -49 
