-51 -55 -55 -55 -57 -57 -57 -55 -55 -55 
-57 -55 -55 -55 -55 -55 -57 -57 -57 -55 
-55 -55 -55 -55 -57 -55 -53 -53 -53 -53 
-53 -53 -53 -55 -55 -55 -55 -53 -53 -55 
-53 -53 -53 -53 -53 -53 -53 -55 -53 -53 
-53 -53 -53 -53 -47 -53 -53 -53 -53 -53 
-51 -51 -53 -53 -51 -53 -53 -53 -55 -55 
-55 -55 -57 -55 -55 -55 -55 -55 -57 -55 
-55 -57 -55 -55 -57 -55 -53 -55 -53 -53 
-55 -53 -53 -55 -53 -53 -55 -55 -55 -55 
-55 -53 -55 -55 -55 -53 -55 -55 -53 -55 
-55 -53 -55 -55 -55 -55 -55 -53 -55 -53 
-55 -53 -55 -83 -55 -53 -53 -53 -53 -53 
-53 -55 -53 -55 -53 -55 -53 -53 -55 -57 
-91 -55 -55 -55 -53 -55 -53 -53 -53 -55 
-53 -55 -55 -53 -55 -55 -53 -53 -51 -55 
-53 -53 -51 -55 -53 -57 -55 -55 -55 -55 
-55 -57 -55 -53 -53 -51 -53 -55 -55 -55 
-53 -53 -55 -53 -55 -55 -57 -55 -57 -57 
-59 -59 -59 -61 -59 -61 -55 -53 -57 -53 
-55 -53 -55 -55 -55 -55 -53 -55 -53 -55 
-53 -53 -53 -57 -55 -55 -55 -55 -55 -55 
-53 -59 -59 -55 -53 -53 -57 -59 -57 -55 
-53 -51 -51 -51 -53 -53 -53 -53 -55 -53 
-51 -55 -55 -55 -57 -55 -55 -57 -55 -57 
-57 -55 -55 -55 -55 -55 -55 -55 -55 -55 
-55 -55 -53 -57 -55 -55 -53 -55 -55 -55 
-57 -55 -55 -55 -55 -55 -55 -57 -53 -55 
-55 -55 -55 -55 -55 -55 -55 -57 -55 -57 
-55 -57 -57 -57 -55 -55 -55 -55 -55 -55 
-55 -55 -55 -55 -55 -55 -57 -55 -55 -53 
-55 -55 -55 -53 -55 -55 -53 -53 -55 -53 
-55 -53 -53 -53 -55 -53 -55 -55 -55 -53 
-55 -53 -55 -55 -55 -55 -55 -55 -55 -55 
-55 -55 -55 -55 -55 -55 -55 -55 -55 -55 
-55 -55 -55 -53 -53 -53 -55 -55 -53 -53 
-53 -55 -55 -53 -55 -53 -55 -55 -55 -53 
-55 -53 -57 -55 -57 -57 -55 -55 -55 -55 
-55 -55 -57 -53 -57 -55 -55 -55 -57 -57 
-57 -57 -55 -55 -55 -57 -55 -57 -55 -91 
-51 -51 -51 -53 -55 -55 -55 -51 -53 -53 
-55 -51 -53 -53 -55 -55 -55 -53 -53 -53 
-55 -55 -55 -55 -55 -55 -55 -53 -53 -53 
-55 -53 -53 -55 -53 -55 -55 -53 -55 -55 
-53 -55 -55 -55 -55 -55 -55 -57 -53 -55 
-55 -57 -55 -55 -57 -53 -53 -55 -57 -53 
-55 -55 -55 -57 -53 -53 -55 -53 -55 -55 
-55 -55 -55 -55 -53 -55 -53 -53 -53 -55 
-53 -57 -55 -57 -55 -55 -53 -57 -59 -57 
-57 -57 -55 -53 -57 -55 -53 -51 -55 -55 
-57 -57 -59 -57 -55 -55 -55 -55 -61 -59 
-55 -69 -59 -61 -59 -59 -57 -57 -57 -55 
-55 -55 -55 -53 -59 -57 -57 -55 -57 -55 
-55 -55 -59 -63 -55 -59 -63 -57 -57 -57 
-57 -55 -55 -55 -57 -55 -57 -57 -57 -57 
-57 -55 -57 -57 -57 -57 -57 -57 -57 -57 
-57 -53 -55 -55 -59 -59 -61 -59 -59 -57 
-55 -55 -53 -55 -53 -55 -53 -53 -55 -55 
-55 -57 -55 -55 -53 -53 -53 -55 -53 -55 
-53 -57 -57 -55 -55 -53 -53 -55 -55 -55 
-53 -55 -55 -57 -55 -53 -53 -53 -55 -55 
-55 -53 -57 -55 -53 -53 -53 -53 -55 -55 
-53 -45 -53 -57 -55 -57 -55 -55 -53 -55 
-53 -55 -55 -55 -53 -57 -55 -55 -57 -53 
-53 -51 -55 -53 -55 -53 -55 -53 -53 -55 
-53 -53 -53 -55 -53 -55 -53 -57 -55 -55 
-55 -55 -53 -91 -53 -55 -53 -55 -55 -55 
-53 -55 -55 -55 -55 -55 -57 -55 -57 -57 
-57 -55 -59 -59 -59 -57 -57 -59 -57 -55 
-59 -57 -57 -55 -55 -57 -53 -53 -55 -57 
-59 -57 -59 -59 -57 -57 -59 -57 -59 -59 
-57 -59 -59 -57 -57 -55 -55 -57 -53 -53 
-53 -55 -53 -57 -53 -55 -55 -55 -55 -57 
-53 -55 -57 -57 -55 -55 -53 -55 -53 -55 
-57 -57 -57 -59 -59 -59 -59 -59 -57 -55 
-55 -53 -55 -55 -43 -57 -57 -55 -53 -55 
-53 -55 -55 -55 -53 -53 -55 -55 -53 -55 
-45 -55 -53 -53 -55 -55 -55 -53 -55 -53 
-53 -53 -55 -53 -55 -55 -55 -55 -55 -55 
-55 -57 -57 -55 -55 -55 -57 -55 -53 -53 
-55 -55 -55 -55 -53 -53 -55 -53 -55 -53 
-53 -55 -53 -51 -53 -53 -53 -55 -55 -55 
-55 -55 -55 -53 -53 -53 -55 -53 -53 -53 
-55 -55 -55 -53 -55 -53 -53 -53 -55 -53 
-53 -75 -55 -53 -55 -53 -53 -53 -55 -55 
-53 -53 -53 -53 -53 -53 -55 -53 -53 -55 
-53 -53 -51 -53 -53 -55 -53 -53 -53 -53 
-53 -55 -53 -53 -53 -53 -55 -53 -53 -53 
-55 -55 -53 -53 -55 -53 -53 -53 -53 -53 
-51 -53 -53 -55 -53 -53 -53 -53 -53 -53 
-53 -53 -53 -53 -51 -53 -55 -55 -55 -55 
-53 -53 -55 -55 -53 -55 -55 -53 -55 -55 
-53 -55 -55 -53 -53 -55 -55 -47 -55 -53 
-53 -55 -55 -91 -55 -55 -53 -53 -53 -55 
-55 -55 -53 -53 -53 -53 -53 -53 -53 -53 
-55 -53 -53 -53 -89 -55 -55 -55 -55 -55 
-55 -55 -53 -57 -55 -57 -53 -53 -53 -53 
-53 -51 -51 -51 -53 -53 -55 -55 -51 -51 
-51 -51 -51 -53 -51 -53 -51 -55 -57 -57 
-57 -55 -53 -55 -53 -55 -53 -57 -47 -53 
-53 -53 -55 -55 -55 -53 -59 -59 -57 -57 
-57 -53 -55 -55 -53 -57 -59 -59 -89 -55 
-53 -57 -57 -59 -57 -59 -43 -59 -57 -59 
-57 -53 -51 -53 -53 -51 -51 -53 -53 -53 
-51 -57 -55 -55 -55 -87 -57 -55 -55 -55 
-55 -53 -55 -53 -53 -53 -55 -53 -53 -53 
-55 -57 -55 -53 -55 -55 -55 -55 -55 -57 
-57 -57 -57 -59 -53 -51 -55 -53 -53 -53 
-55 -55 -55 -55 -55 -55 -57 -55 -53 -55 
-53 -55 -55 -55 -53 -55 -53 -55 -55 -55 
-53 -53 -55 -55 -91 -55 -55 -53 -55 -53 
-55 -53 -55 -53 -55 -53 -55 -53 -55 -55 
-55 -53 -55 -55 -55 -91 -55 -53 -55 -53 
-55 -53 -53 -53 -55 -53 -55 -53 -55 -51 
-55 -55 -55 -53 -55 -55 -55 -53 -55 -53 
-55 -55 -51 -53 -53 -55 -53 -53 -53 -55 
-55 -55 -53 -55 -53 -53 -53 -55 -51 -55 
-53 -55 -55 -55 -53 -55 -55 -51 -55 -55 
-55 -53 -55 -55 -53 -53 -53 -87 -53 -55 
-53 -53 -53 -53 -55 -55 -53 -55 -53 -55 
-53 -53 -53 -53 -53 -55 -55 -53 -51 -55 
-53 -53 -55 -53 -53 -53 -53 -55 -53 -55 
-53 -53 -53 -55 -53 -53 -53 -55 -55 -53 
-53 -51 -55 -53 -55 -53 -55 -53 -55 -53 
-55 -53 -53 -53 -53 -53 -53 -53 -53 -53 
-55 -55 -53 -53 -51 -51 -51 -49 -53 -51 
-51 -51 -51 -53 -51 -53 -51 -53 -51 -53 
-55 -53 -53 -53 -53 -53 -53 -51 -53 -53 
-53 -53 -53 -53 -55 -55 -55 -53 -53 -53 
-57 -57 -55 -53 -53 -55 -55 -55 -53 -57 
-55 -55 -57 -53 -51 -55 -51 -57 -53 -57 
-55 -55 -51 -55 -55 -57 -53 -53 -51 -53 
-51 -55 -55 -55 -55 -53 -51 -55 -49 -55 
-57 -55 -55 -55 -53 -53 -53 -55 -51 -53 
-53 -53 -53 -53 -55 -53 -55 -55 -55 -53 
-55 -53 -55 -53 -53 -53 -53 -51 -53 -53 
-55 -55 -53 -53 -55 -53 -55 -55 -55 -53 
-53 -53 -53 -53 -53 -55 -51 -55 -51 -55 
-53 -55 -53 -55 -53 -53 -53 -55 -55 -55 
-53 -55 -55 -55 -55 -53 -53 -53 -53 -55 
-51 -53 -53 -53 -55 -53 -55 -53 -55 -53 
-55 -55 -53 -53 -55 -53 -55 -53 -55 -55 
-53 -53 -53 -53 -53 -53 -53 -55 -53 -53 
-51 -53 -53 -55 -53 -55 -53 -53 -53 -55 
-51 -53 -51 -53 -51 -53 -51 -53 -51 -53 
-51 -51 -53 -53 -53 -51 -53 -53 -55 -51 
-53 -53 -53 -51 -55 -53 -53 -53 -53 -55 
-53 -55 -53 -55 -51 -55 -53 -55 -53 -53 
-53 -51 -55 -53 -55 -53 -55 -53 -53 -53 
-53 -53 -53 -53 -53 -55 -53 -55 -55 -53 
-51 -53 -53 -53 -55 -53 -55 -55 -55 -53 
-53 -53 -53 -53 -53 -53 -53 -53 -53 -53 
-53 -51 -53 -51 -55 -53 -53 -53 -53 -55 
-55 -53 -51 -55 -55 -53 -53 -53 -55 -51 
-53 -53 -53 -53 -53 -51 -53 -53 -51 -53 
-49 -53 -53 -55 -53 -53 -53 -53 -53 -53 
-53 -53 -53 -55 -55 -51 -55 -53 -53 -47 
-55 -53 -55 -53 -55 -55 -55 -55 -53 -53 
-53 -53 -53 -55 -51 -53 -53 -57 -53 -53 
-55 -53 -55 -53 -53 -53 -53 -53 -53 -53 
-53 -55 -55 -53 -55 -53 -55 -53 -55 -53 
-53 -51 -89 -55 -55 -55 -53 -53 -53 -55 
-55 -57 -55 -53 -55 -55 -53 -53 -53 -49 
-55 -53 -53 -53 -53 -53 -47 -55 -55 -57 
-55 -55 -55 -55 -53 -89 -53 -53 -53 -51 
-55 -57 -55 -53 -53 -53 -53 -57 -55 -57 
-55 -55 -57 -55 -57 -55 -53 -55 -53 -43 
-53 -55 -55 -53 -55 -53 -55 -57 -57 -53 
-55 -55 -55 -53 -53 -53 -55 -43 -55 -57 
-57 -55 -55 -55 -55 -55 -55 -55 -55 -53 
-55 -53 -55 -53 -55 -53 -53 -55 -55 -53 
-53 -53 -53 -53 -55 -55 -51 -55 -53 -53 
-53 -53 -53 -55 -53 -55 -55 -55 -53 -55 
-53 -55 -87 -53 -45 -53 -51 -53 -53 -53 
-55 -53 -55 -55 -53 -53 -55 -53 -53 -53 
-55 -53 -55 -53 -57 -55 -55 -53 -55 -55 
-55 -53 -53 -53 -57 -55 -53 -53 -53 -53 
-55 -53 -53 -53 -51 -55 -55 -55 -55 -43 
-53 -55 -53 -55 -55 -53 -53 -55 -53 -55 
-51 -55 -53 -55 -53 -55 -53 -55 -53 -55 
-53 -55 -55 -53 -51 -55 -53 -55 -55 -53 
-53 -55 -55 -55 -53 -55 -53 -55 -55 -55 
-53 -53 -53 -53 -57 -55 -53 -53 -55 -53 
-53 -55 -53 -53 -53 -55 -53 -55 -53 -53 
-53 -53 -55 -55 -53 -55 -55 -55 -51 -55 
-53 -53 -53 -55 -55 -55 -53 -53 -53 -53 
-51 -55 -53 -55 -55 -51 -53 -55 -55 -53 
-53 -53 -55 -53 -55 -53 -51 -53 -55 -55 
-55 -55 -55 -53 -55 -53 -55 -55 -53 -53 
-53 -55 -55 -53 -55 -53 -55 -55 -55 -53 
-55 -55 -55 -55 -49 -53 -53 -55 -53 -55 
-53 -55 -55 -55 -53 -55 -55 -55 -55 -55 
-55 -55 -53 -55 -55 -55 -55 -55 -55 -55 
-53 -55 -53 -55 -53 -55 -53 -55 -55 -55 
-55 -53 -53 -53 -55 -55 -53 -55 -53 -55 
-55 -55 -55 -53 -55 -55 -55 -55 -55 -53 
-53 -53 -55 -55 -55 -55 -55 -53 -55 -53 
-53 -55 -53 -53 -55 -53 -53 -53 -53 -53 
-53 -55 -53 -53 -55 -55 -55 -55 -53 -55 
-53 -53 -53 -53 -53 -53 -53 -55 -55 -55 
-53 -55 -55 -53 -53 -55 -53 -55 -53 -53 
-53 -55 -53 -53 -53 -53 -55 -53 -55 -55 
-55 -53 -55 -53 -55 -53 -55 -53 -53 -53 
-55 -51 -53 -53 -53 -53 -53 -55 -55 -53 
-53 -53 -55 -53 -53 -51 -53 -53 -53 -53 
-53 -53 -53 -51 -53 -53 -55 -55 -53 -53 
-53 -53 -53 -53 -55 -53 -53 -53 -53 -53 
-55 -55 -55 -53 -51 -55 -55 -53 -55 -53 
-53 -55 -55 -55 -55 -55 -55 -55 -55 -55 
-53 -55 -53 -87 -55 -53 -53 -55 -53 -55 
-51 -55 -55 -53 -53 -53 -53 -55 -53 -53 
-51 -53 -53 -53 -53 -53 -55 -53 -53 -53 
-53 -55 -55 -53 -55 -53 -51 -55 -53 -55 
-51 -55 -55 -55 -53 -55 -53 -55 -53 -55 
-53 -55 -53 -55 -51 -55 -53 -53 -55 -53 
-53 -53 -53 -53 -53 -53 -53 -53 -55 -91 
-51 -53 -53 -55 -53 -55 -53 -55 -55 -55 
-53 -55 -53 -55 -53 -55 -55 -55 -53 -55 
-53 -55 -51 -55 -53 -55 -55 -53 -55 -55 
-85 -53 -53 -55 -53 -51 -53 -53 -53 -55 
-53 -55 -53 -85 -55 -53 -55 -53 -55 -55 
-55 -53 -55 -55 -53 -53 -51 -53 -53 -55 
-51 -55 -53 -55 -53 -53 -53 -53 -55 -53 
-53 -55 -55 -55 -43 -53 -51 -53 -53 -91 
-55 -55 -53 -53 -55 -53 -53 -53 -53 -53 
-55 -55 -55 -53 -53 -55 -55 -51 -55 -51 
-53 -53 -53 -55 -91 -53 -55 -53 -55 -53 
-53 -51 -53 -53 -55 -55 -55 -53 -55 -55 
-55 -55 -55 -53 -55 -53 -55 -53 -55 -51 
-55 -53 -51 -89 -53 -55 -51 -53 -53 -53 
-53 -53 -87 -87 -53 -53 -55 -51 -55 -53 
-53 -53 -53 -53 -53 -51 -55 -55 -91 -53 
-51 -55 -53 -53 -53 -55 -55 -53 -91 -55 
-55 -53 -53 -55 -53 -53 -53 -55 -55 -53 
-55 -53 -53 -53 -53 -53 -55 -53 -55 -55 
-55 -55 -55 -55 -53 -53 -55 -53 -57 -57 
-53 -53 -55 -51 -53 -55 -53 -53 -55 -53 
-55 -53 -53 -55 -51 -55 -53 -53 -53 -55 
-53 -43 -53 -53 -53 -91 -57 -55 -55 -55 
-53 -55 -53 -55 -55 -55 -53 -53 -55 -53 
-55 -53 -55 -53 -55 -55 -55 -57 -57 -55 
-55 -55 -55 -57 -53 -53 -53 -53 -51 -55 
-55 -53 -53 -57 -55 -55 -55 -55 -87 -53 
-53 -55 -57 -55 -55 -55 -55 -55 -53 -57 
-57 -55 -53 -55 -53 -51 -53 -53 -55 -53 
-57 -57 -53 -53 -55 -53 -55 -55 -57 -57 
-55 -55 -55 -51 -51 -51 -53 -53 -57 -55 
-53 -55 -55 -55 -57 -57 -61 -57 -43 -55 
-55 -57 -57 -53 -55 -55 -57 -57 -59 -57 
-59 -57 -57 -57 -59 -55 -57 -57 -59 -59 
-61 -59 -61 -57 -55 -57 -57 -91 -57 -53 
-53 -55 -55 -53 -53 -55 -55 -55 -55 -53 
-51 -53 -53 -53 -51 -51 -51 -53 -51 -53 
-55 -53 -53 -55 -53 -55 -55 -53 -53 -55 
-55 -55 -55 -57 -55 -55 -57 -55 -55 -55 
-55 -55 -53 -53 -53 -55 -55 -57 -57 -57 
-55 -55 -55 -53 -55 -55 -57 -89 -55 -55 
-55 -53 -55 -53 -57 -53 -53 -91 -91 -55 
-55 -53 -51 -55 -55 -53 -53 -53 -53 -53 
-53 -55 -53 -55 -55 -53 -55 -55 -51 -55 
-53 -55 -55 -53 -55 -53 -53 -89 -55 -55 
-55 -53 -55 -55 -55 -53 -55 -51 -55 -57 
-53 -51 -55 -53 -53 -53 -51 -55 -55 -53 
-55 -55 -53 -53 -53 -53 -53 -53 -55 -55 
-53 -53 -53 -53 -53 -53 -53 -53 -53 -53 
-53 -55 -53 -55 -53 -55 -51 -55 -53 -53 
-53 -53 -55 -53 -53 -53 -55 -53 -55 -53 
-55 -53 -53 -55 -53 -53 -55 -53 -55 -79 
-53 -55 -53 -53 -53 -55 -53 -55 -53 -53 
-53 -55 -55 -53 -53 -53 -53 -53 -53 -53 
-53 -53 -53 -55 -53 -55 -53 -51 -53 -53 
-55 -53 -55 -55 -55 -53 -55 -55 -55 -55 
-55 -53 -55 -55 -55 -53 -55 -53 -53 -55 
-55 -53 -53 -55 -55 -53 -53 -53 -51 -55 
-53 -55 -53 -53 -53 -55 -53 -55 -55 -55 
-53 -55 -51 -53 -53 -55 -53 -55 -53 -55 
-53 -55 -55 -55 -53 -53 -53 -55 -55 -53 
-55 -53 -53 -55 -55 -55 -55 -53 -55 -55 
-55 -53 -55 -53 -55 -53 -53 -53 -55 -53 
-53 -55 -53 -55 -55 -53 -55 -53 -55 -53 
-55 -55 -55 -53 -55 -53 -55 -53 -53 -55 
-53 -53 -55 -53 -91 -55 -55 -53 -55 -53 
-55 -51 -55 -53 -53 -55 -53 -53 -53 -53 
-53 -53 -55 -53 -53 -53 -53 -55 -55 -53 
-55 -55 -53 -55 -55 -55 -55 -55 -53 -55 
-55 -55 -53 -55 -53 -53 -53 -53 -53 -55 
-55 -53 -55 -53 -55 -53 -55 -53 -55 -53 
-53 -53 -55 -53 -55 -53 -55 -53 -55 -53 
-55 -55 -55 -53 -53 -53 -55 -55 -53 -55 
-55 -53 -53 -53 -53 -55 -55 -55 -55 -55 
-53 -55 -53 -55 -55 -53 -55 -55 -55 -55 
-55 -53 -55 -53 -53 -53 -55 -51 -55 -53 
-55 -53 -53 -53 -55 -53 -53 -53 -53 -53 
-53 -55 -53 -55 -55 -55 -53 -55 -53 -51 
-55 -53 -55 -53 -55 -55 -53 -55 -53 -55 
-55 -55 -53 -55 -53 -55 -53 -53 -53 -55 
-53 -55 -55 -55 -55 -53 -55 -53 -55 -55 
-55 -55 -55 -55 -53 -53 -53 -55 -53 -53 
-85 -85 -55 -51 -53 -91 -51 -55 -53 -53 
-53 -55 -53 -55 -53 -55 -53 -55 -53 -55 
