-41 -43 -43 -43 -43 -43 -43 -43 -43 -43 
-43 -43 -43 -43 -43 -41 -43 -45 -43 -43 
-43 -43 -43 -43 -43 -43 -43 -43 -43 -43 
-43 -43 -41 -43 -43 -43 -43 -43 -43 -45 
-45 -45 -43 -43 -45 -43 -45 -45 -43 -43 
-45 -45 -45 -45 -43 -41 -45 -43 -43 -45 
-43 -43 -43 -41 -43 -43 -43 -43 -43 -43 
-43 -41 -43 -43 -43 -43 -43 -43 -43 -43 
-41 -43 -43 -43 -43 -41 -43 -43 -43 -43 
-43 -43 -43 -43 -43 -43 -43 -43 -43 -45 
-43 -43 -43 -43 -43 -41 -45 -45 -45 -43 
-43 -43 -45 -43 -43 -43 -45 -43 -43 -43 
-43 -43 -43 -43 -43 -43 -43 -43 -41 -45 
-43 -45 -43 -43 -45 -43 -43 -45 -43 -43 
-45 -91 -43 -43 -43 -45 -43 -43 -43 -43 
-43 -43 -43 -43 -45 -43 -43 -45 -45 -43 
-43 -43 -45 -43 -43 -43 -43 -45 -43 -43 
-43 -43 -43 -45 -43 -43 -43 -45 -43 -43 
-45 -43 -43 -43 -43 -43 -43 -43 -43 -43 
-45 -43 -43 -43 -43 -45 -45 -91 -91 -43 
-41 -43 -43 -43 -43 -43 -43 -43 -43 -43 
-43 -43 -43 -45 -43 -43 -41 -45 -43 -43 
-43 -43 -43 -43 -43 -45 -43 -43 -43 -43 
-43 -43 -43 -43 -45 -43 -43 -43 -43 -43 
-43 -45 -43 -43 -43 -43 -43 -43 -43 -43 
-41 -43 -43 -43 -43 -43 -41 -43 -43 -43 
-43 -43 -43 -43 -43 -43 -43 -43 -45 -43 
-43 -43 -43 -43 -43 -43 -43 -43 -43 -45 
-43 -43 -45 -43 -45 -45 -45 -43 -41 -45 
-43 -43 -43 -45 -43 -43 -45 -45 -43 -43 
-43 -45 -45 -43 -45 -89 -45 -45 -43 -91 
-43 -43 -43 -43 -43 -45 -45 -45 -45 -43 
-91 -41 -43 -43 -43 -43 -43 -43 -45 -43 
-45 -45 -43 -45 -43 -45 -43 -43 -43 -43 
-43 -43 -43 -45 -45 -43 -45 -45 -45 -45 
-43 -43 -43 -45 -45 -45 -43 -43 -43 -45 
-43 -43 -43 -43 -43 -45 -91 -43 -45 -43 
-43 -45 -43 -45 -45 -45 -43 -45 -45 -45 
-45 -43 -45 -43 -43 -43 -43 -45 -45 -43 
-43 -45 -43 -43 -43 -45 -45 -43 -43 -43 
-73 -43 -43 -43 -43 -43 -45 -45 -45 -45 
-43 -45 -43 -43 -43 -43 -45 -45 -43 -43 
-45 -41 -43 -45 -45 -43 -43 -45 -43 -45 
-43 -45 -43 -43 -43 -43 -45 -43 -43 -43 
-45 -43 -43 -43 -43 -43 -43 -45 -43 -43 
-43 -45 -43 -45 -43 -43 -43 -43 -43 -43 
-43 -43 -43 -43 -43 -53 -43 -43 -43 -43 
-45 -43 -43 -43 -43 -43 -43 -43 -43 -43 
-43 -43 -43 -41 -43 -43 -43 -43 -43 -89 
-45 -43 -43 -43 -43 -43 -45 -43 -43 -43 
-45 -43 -43 -43 -43 -43 -43 -43 -43 -43 
-43 -43 -45 -43 -43 -45 -43 -43 -43 -43 
-43 -43 -45 -43 -43 -43 -43 -43 -43 -43 
-43 -43 -45 -43 -43 -45 -45 -43 -43 -43 
-45 -43 -43 -41 -43 -43 -43 -43 -43 -45 
-43 -45 -45 -45 -43 -43 -43 -43 -45 -43 
-41 -41 -43 -43 -43 -43 -43 -41 -43 -43 
-43 -41 -43 -43 -43 -43 -43 -43 -43 -43 
-43 -43 -43 -43 -43 -43 -43 -43 -43 -43 
-43 -43 -43 -43 -43 -43 -43 -43 -91 -43 
-43 -43 -43 -43 -43 -43 -43 -43 -43 -43 
-43 -43 -43 -45 -43 -43 -43 -43 -43 -43 
-43 -43 -43 -43 -91 -43 -43 -41 -43 -43 
-43 -43 -43 -43 -43 -43 -43 -43 -43 -43 
-43 -43 -43 -43 -43 -43 -43 -45 -43 -43 
-41 -43 -45 -43 -43 -43 -43 -85 -43 -43 
-43 -45 -43 -41 -43 -43 -41 -43 -43 -43 
-43 -43 -43 -43 -43 -45 -43 -45 -43 -45 
-43 -43 -41 -43 -43 -43 -43 -41 -41 -41 
-41 -41 -41 -41 -41 -41 -41 -41 -41 -43 
-41 -41 -43 -41 -41 -43 -43 -41 -41 -41 
-41 -41 -41 -91 -41 -41 -43 -43 -43 -41 
-43 -43 -43 -43 -41 -89 -41 -41 -41 -43 
-43 -41 -41 -41 -41 -43 -41 -41 -43 -41 
-41 -41 -41 -39 -43 -43 -41 -43 -41 -43 
-41 -41 -41 -41 -43 -41 -41 -41 -41 -41 
-43 -41 -43 -41 -41 -41 -41 -41 -41 -41 
-41 -41 -43 -41 -43 -39 -43 -41 -43 -41 
-41 -41 -41 -41 -41 -43 -41 -41 -43 -41 
-43 -45 -43 -41 -43 -41 -41 -43 -43 -41 
-39 -43 -41 -43 -43 -41 -43 -43 -43 -41 
-43 -43 -43 -43 -43 -41 -43 -43 -43 -43 
-41 -41 -41 -43 -43 -43 -43 -43 -41 -43 
-43 -43 -43 -43 -43 -43 -43 -43 -43 -43 
-43 -41 -43 -41 -43 -45 -43 -43 -43 -43 
-43 -41 -43 -43 -43 -43 -43 -43 -43 -43 
-43 -43 -43 -43 -43 -43 -43 -43 -43 -43 
-43 -45 -43 -43 -43 -43 -43 -43 -43 -43 
-43 -45 -43 -43 -43 -43 -43 -43 -45 -43 
-43 -45 -45 -43 -43 -91 -43 -43 -43 -43 
-43 -43 -43 -43 -43 -45 -45 -43 -43 -43 
-43 -45 -41 -43 -43 -45 -43 -43 -43 -43 
-45 -43 -45 -43 -45 -43 -43 -43 -45 -43 
-45 -41 -45 -43 -43 -43 -45 -43 -43 -43 
-43 -43 -43 -43 -43 -43 -45 -43 -43 -43 
-43 -45 -45 -43 -43 -43 -43 -41 -91 -43 
-43 -45 -43 -43 -43 -43 -43 -43 -43 -43 
-43 -45 -43 -43 -43 -43 -45 -43 -43 -41 
-43 -43 -45 -43 -43 -43 -43 -43 -43 -43 
-43 -43 -43 -43 -43 -43 -43 -43 -43 -43 
-43 -43 -43 -45 -43 -43 -43 -43 -43 -43 
-43 -45 -41 -43 -43 -45 -43 -41 -49 -43 
-43 -43 -43 -41 -43 -43 -43 -43 -43 -41 
-43 -43 -45 -43 -43 -43 -45 -45 -43 -43 
-43 -45 -43 -45 -45 -43 -43 -43 -45 -43 
-43 -43 -43 -43 -43 -43 -45 -43 -43 -45 
-45 -43 -43 -43 -43 -45 -45 -43 -45 -43 
-43 -45 -45 -43 -43 -43 -43 -43 -43 -43 
-45 -43 -43 -43 -45 -45 -45 -45 -45 -47 
-45 -45 -45 -45 -45 -45 -43 -43 -43 -45 
-43 -43 -45 -45 -43 -43 -45 -45 -43 -45 
-43 -45 -45 -43 -43 -45 -43 -43 -45 -43 
-43 -39 -43 -43 -45 -45 -43 -43 -43 -45 
-43 -43 -43 -43 -43 -41 -43 -43 -43 -43 
-43 -43 -43 -45 -43 -43 -45 -43 -43 -43 
-43 -43 -43 -43 -43 -45 -41 -91 -43 -43 
-43 -45 -45 -43 -43 -43 -43 -43 -43 -43 
-43 -43 -43 -43 -41 -43 -43 -43 -43 -43 
-43 -43 -43 -43 -43 -43 -43 -91 -43 -41 
-43 -41 -43 -43 -43 -41 -43 -41 -43 -41 
-45 -41 -45 -43 -43 -43 -43 -43 -43 -43 
-43 -43 -43 -45 -43 -43 -43 -43 -43 -43 
-43 -89 -43 -41 -43 -43 -43 -43 -91 -43 
-43 -43 -43 -43 -45 -43 -41 -43 -43 -43 
-43 -43 -43 -43 -43 -43 -43 -43 -43 -43 
-43 -43 -43 -43 -43 -45 -43 -43 -45 -43 
-43 -91 -45 -43 -43 -43 -43 -43 -43 -43 
-41 -43 -43 -43 -43 -43 -43 -43 -43 -43 
-43 -43 -43 -43 -43 -43 -43 -43 -45 -43 
-43 -43 -43 -45 -43 -43 -43 -43 -45 -45 
-43 -91 -43 -43 -45 -43 -43 -43 -43 -43 
-43 -43 -43 -45 -45 -43 -43 -43 -41 -43 
-43 -43 -43 -43 -43 -43 -43 -43 -41 -43 
-43 -43 -43 -43 -43 -43 -43 -41 -43 -45 
-43 -45 -43 -43 -43 -45 -43 -45 -43 -43 
-43 -43 -43 -43 -43 -43 -43 -43 -43 -43 
-43 -43 -41 -43 -43 -43 -45 -43 -43 -43 
-43 -43 -43 -43 -43 -43 -41 -43 -43 -43 
-45 -43 -43 -43 -43 -43 -45 -43 -43 -43 
-45 -43 -43 -43 -43 -43 -43 -43 -43 -43 
-43 -43 -43 -43 -43 -43 -43 -45 -43 -43 
-43 -43 -43 -43 -43 -43 -43 -43 -41 -45 
-43 -45 -45 -43 -43 -43 -43 -43 -43 -91 
-43 -43 -45 -43 -43 -43 -91 -43 -43 -45 
-43 -43 -43 -43 -43 -43 -91 -43 -45 -43 
-43 -43 -43 -45 -43 -43 -45 -43 -43 -43 
-43 -43 -43 -41 -91 -43 -43 -43 -43 -45 
-45 -43 -43 -45 -43 -43 -43 -43 -43 -43 
-43 -43 -41 -43 -43 -43 -43 -45 -43 -43 
-43 -43 -43 -43 -43 -43 -43 -43 -43 -43 
-43 -43 -89 -43 -45 -43 -43 -43 -45 -43 
-43 -43 -43 -45 -43 -45 -43 -43 -43 -43 
-43 -41 -43 -43 -43 -43 -43 -43 -43 -43 
-43 -43 -45 -43 -41 -43 -43 -43 -43 -43 
-53 -53 -43 -43 -43 -43 -43 -43 -43 -43 
-43 -43 -43 -43 -43 -43 -43 -45 -43 -43 
-43 -41 -43 -45 -43 -43 -43 -43 -43 -43 
-43 -45 -43 -43 -43 -43 -45 -43 -43 -43 
-43 -43 -43 -43 -43 -43 -45 -43 -87 -43 
-43 -43 -43 -43 -43 -43 -43 -43 -43 -43 
-43 -43 -43 -43 -43 -43 -43 -43 -43 -43 
-45 -43 -43 -43 -43 -43 -43 -43 -43 -43 
-43 -43 -43 -43 -43 -43 -43 -43 -43 -43 
-45 -43 -43 -43 -45 -43 -41 -43 -43 -43 
-43 -43 -45 -43 -43 -43 -43 -43 -45 -43 
-45 -43 -43 -43 -43 -43 -43 -41 -43 -41 
-43 -43 -43 -43 -43 -43 -43 -43 -43 -43 
-43 -43 -43 -43 -43 -43 -43 -45 -43 -43 
-43 -45 -43 -43 -43 -43 -45 -43 -45 -43 
-41 -43 -43 -45 -43 -41 -43 -43 -45 -89 
-43 -43 -43 -43 -91 -43 -43 -43 -43 -89 
-43 -45 -43 -45 -43 -43 -43 -43 -43 -41 
-43 -45 -43 -45 -91 -43 -43 -45 -43 -91 
-43 -43 -43 -43 -43 -43 -43 -43 -43 -43 
-43 -43 -43 -43 -45 -43 -43 -43 -43 -43 
-43 -45 -43 -43 -43 -43 -43 -43 -43 -43 
-43 -43 -43 -43 -43 -43 -45 -43 -43 -43 
-43 -43 -43 -43 -43 -43 -43 -45 -43 -43 
-45 -43 -43 -43 -77 -43 -45 -43 -43 -43 
-43 -43 -43 -43 -45 -43 -43 -43 -43 -43 
-43 -43 -43 -43 -43 -43 -81 -43 -43 -43 
-43 -43 -43 -43 -43 -43 -43 -43 -43 -43 
-43 -43 -43 -43 -43 -43 -43 -43 -43 -43 
-43 -43 -43 -43 -43 -43 -43 -43 -43 -43 
-43 -43 -43 -43 -43 -43 -43 -43 -43 -45 
-43 -43 -43 -43 -43 -45 -43 -43 -43 -43 
-43 -43 -43 -43 -43 -41 -43 -43 -43 -43 
-43 -41 -43 -43 -43 -43 -43 -43 -43 -43 
-43 -43 -43 -43 -43 -43 -43 -43 -43 -43 
-41 -43 -43 -43 -43 -43 -43 -89 -43 -43 
-43 -43 -43 -43 -43 -41 -45 -43 -43 -43 
-43 -43 -43 -43 -43 -43 -43 -43 -43 -43 
-43 -43 -43 -43 -43 -43 -43 -43 -43 -43 
-43 -43 -43 -43 -43 -43 -43 -43 -43 -43 
-43 -43 -43 -43 -43 -43 -45 -43 -43 -43 
-43 -43 -43 -43 -43 -43 -43 -43 -43 -49 
-49 -91 -43 -43 -43 -43 -43 -43 -43 -43 
-43 -41 -43 -43 -43 -43 -43 -43 -43 -43 
-43 -43 -43 -43 -43 -89 -89 -43 -43 -43 
-43 -43 -43 -43 -43 -43 -43 -45 -43 -43 
-45 -45 -43 -43 -43 -45 -43 -43 -43 -41 
-43 -43 -43 -43 -43 -43 -43 -45 -43 -43 
-43 -43 -43 -43 -41 -43 -43 -43 -43 -43 
-43 -41 -43 -77 -43 -43 -43 -43 -43 -43 
-43 -41 -43 -43 -45 -43 -43 -43 -43 -43 
-43 -43 -43 -43 -43 -43 -43 -43 -41 -43 
-43 -43 -43 -43 -43 -43 -43 -43 -43 -43 
-43 -43 -43 -43 -43 -43 -43 -43 -43 -43 
-43 -43 -45 -45 -41 -43 -45 -43 -43 -43 
-45 -43 -43 -45 -45 -45 -41 -43 -43 -43 
-43 -41 -43 -43 -43 -43 -43 -43 -43 -43 
-43 -43 -43 -43 -43 -43 -43 -43 -43 -43 
-43 -43 -41 -43 -41 -43 -41 -43 -43 -43 
-43 -43 -43 -43 -43 -43 -43 -43 -41 -43 
-43 -43 -43 -43 -43 -43 -43 -43 -43 -43 
-43 -43 -43 -43 -43 -43 -43 -43 -41 -43 
-43 -43 -43 -43 -45 -43 -43 -45 -43 -45 
-43 -43 -43 -43 -43 -43 -41 -45 -43 -43 
-43 -41 -43 -43 -43 -43 -43 -43 -43 -43 
-43 -43 -43 -43 -45 -43 -43 -43 -43 -43 
-43 -43 -43 -43 -43 -43 -43 -45 -43 -43 
-45 -45 -43 -43 -43 -43 -43 -43 -43 -43 
-43 -43 -45 -43 -43 -43 -43 -43 -43 -41 
-43 -43 -43 -43 -43 -45 -43 -43 -43 -41 
-43 -43 -43 -43 -91 -43 -43 -43 -43 -43 
-43 -43 -43 -43 -43 -43 -43 -43 -43 -43 
-43 -43 -43 -43 -43 -43 -43 -43 -43 -43 
-43 -43 -43 -43 -43 -43 -43 -43 -43 -43 
-43 -43 -43 -43 -43 -43 -43 -43 -43 -43 
-43 -91 -43 -43 -43 -43 -41 -43 -43 -43 
-43 -43 -43 -43 -43 -45 -43 -43 -43 -43 
-43 -43 -43 -43 -43 -43 -43 -43 -43 -43 
-43 -43 -41 -43 -43 -43 -43 -43 -43 -43 
-43 -43 -45 -43 -41 -43 -43 -43 -45 -45 
-43 -43 -43 -43 -41 -43 -45 -43 -45 -45 
-43 -43 -43 -43 -43 -43 -43 -43 -43 -43 
-43 -43 -43 -43 -43 -43 -43 -43 -43 -43 
-43 -43 -43 -43 -43 -43 -43 -43 -43 -43 
-43 -43 -43 -43 -45 -43 -43 -45 -43 -43 
-43 -43 -45 -41 -43 -43 -43 -43 -43 -43 
-43 -43 -43 -43 -43 -43 -43 -43 -43 -43 
-43 -91 -43 -43 -45 -43 -43 -43 -45 -43 
-43 -43 -43 -43 -43 -43 -41 -43 -43 -43 
-43 -43 -43 -89 -43 -43 -43 -43 -45 -43 
-43 -43 -43 -43 -43 -43 -45 -43 -43 -43 
-41 -43 -43 -43 -43 -43 -43 -41 -43 -43 
-43 -43 -43 -43 -43 -43 -43 -43 -43 -43 
-43 -43 -43 -43 -69 -43 -43 -91 -43 -43 
-43 -43 -43 -43 -43 -43 -43 -45 -43 -45 
-43 -41 -43 -43 -43 -43 -43 -43 -43 -45 
-43 -43 -45 -43 -45 -45 -43 -43 -43 -43 
-43 -43 -43 -43 -41 -43 -45 -43 -41 -43 
-43 -43 -43 -43 -41 -43 -43 -43 -43 -43 
-43 -43 -43 -43 -43 -43 -43 -43 -43 -45 
-43 -43 -43 -43 -43 -43 -43 -43 -43 -43 
-43 -43 -43 -43 -43 -43 -43 -43 -45 -43 
-43 -43 -43 -43 -43 -43 -43 -43 -43 -43 
-43 -43 -43 -43 -43 -43 -43 -43 -43 -43 
-43 -43 -43 -43 -43 -43 -43 -43 -43 -43 
-43 -43 -43 -43 -45 -43 -43 -43 -43 -43 
-43 -41 -43 -43 -43 -43 -43 -43 -43 -43 
-43 -41 -43 -43 -43 -41 -43 -43 -43 -43 
-43 -43 -43 -43 -43 -43 -43 -41 -43 -43 
-43 -43 -43 -43 -43 -43 -43 -43 -43 -43 
-43 -43 -43 -43 -45 -43 -43 -43 -43 -43 
-43 -43 -43 -43 -43 -43 -43 -43 -43 -43 
-43 -43 -43 -43 -43 -43 -41 -43 -43 -43 
-45 -43 -43 -43 -45 -43 -43 -43 -41 -43 
-43 -43 -43 -43 -43 -43 -43 -41 -43 -43 
-91 -43 -45 -43 -43 -43 -43 -41 -43 -45 
-43 -91 -43 -41 -43 -41 -43 -43 -43 -43 
-43 -43 -43 -43 -43 -43 -43 -43 -43 -43 
-45 -43 -43 -43 -43 -43 -43 -43 -43 -43 
-43 -43 -45 -45 -43 -43 -43 -43 -43 -43 
-43 -43 -43 -41 -43 -43 -43 -43 -43 -43 
-43 -45 -43 -43 -43 -43 -43 -43 -43 -87 
-87 -43 -43 -43 -43 -43 -43 -43 -43 -43 
-43 -43 -43 -43 -43 -43 -43 -43 -43 -43 
-45 -43 -43 -43 -43 -43 -43 -43 -43 -43 
-43 -43 -43 -43 -41 -43 -43 -43 -43 -43 
-43 -43 -43 -43 -43 -43 -43 -43 -41 -43 
-41 -43 -43 -43 -43 -43 -43 -43 -45 -43 
-43 -43 -43 -43 -43 -43 -43 -43 -43 -43 
-43 -43 -43 -41 -43 -43 -91 -41 -43 -43 
-43 -43 -43 -43 -43 -43 -43 -43 -43 -43 
-55 -43 -43 -43 -41 -43 -43 -43 -43 -43 
-43 -43 -43 -43 -43 -43 -43 -41 -43 -43 
-43 -45 -43 -43 -41 -43 -43 -43 -43 -43 
-41 -87 -87 -43 -43 -43 -41 -43 -43 -43 
-43 -43 -43 -43 -45 -43 -45 -43 -45 -43 
-43 -43 -43 -43 -43 -43 -43 -43 -43 -43 
-43 -41 -43 -43 -43 -43 -43 -43 -43 -43 
-43 -43 -43 -43 -43 -43 -41 -43 -43 -43 
-45 -43 -43 -43 -43 -43 -43 -41 -43 -43 
-43 -45 -43 -43 -43 -43 -43 -45 -43 -43 
-43 -45 -43 -43 -43 -43 -43 -43 -87 -45 
-45 -43 -43 -43 -43 -43 -43 -43 -43 -43 
-43 -43 -43 -43 -43 -43 -43 -43 -43 -43 
-45 -43 -43 -43 -43 -43 -43 -43 -41 -43 
-41 -45 -41 -43 -43 -43 -43 -43 -43 -43 
