-59 -59 -59 -89 -59 -59 -59 -61 -61 -61 
-61 -59 -61 -61 -61 -61 -59 -75 -63 -77 
-73 -63 -73 -75 -73 -75 -61 -65 -65 -65 
-63 -65 -65 -63 -63 -65 -63 -61 -75 -75 
-63 -65 -63 -63 -63 -61 -75 -75 -63 -63 
-63 -63 -65 -63 -63 -63 -63 -73 -73 -61 
-63 -63 -63 -63 -63 -63 -61 -61 -61 -61 
-61 -63 -61 -61 -61 -61 -59 -61 -59 -59 
-61 -61 -61 -59 -59 -59 -59 -61 -59 -61 
-59 -61 -61 -61 -59 -61 -59 -59 -59 -61 
-59 -59 -61 -61 -61 -61 -59 -61 -59 -61 
-61 -59 -61 -59 -59 -59 -61 -61 -61 -61 
-59 -61 -61 -61 -59 -61 -61 -61 -59 -59 
-59 -59 -59 -59 -59 -59 -59 -59 -59 -61 
-59 -59 -59 -59 -59 -59 -59 -59 -59 -59 
-59 -59 -59 -59 -59 -59 -59 -59 -59 -59 
-61 -59 -61 -59 -59 -59 -59 -59 -59 -59 
-59 -59 -59 -61 -59 -61 -59 -61 -59 -59 
-59 -61 -59 -61 -61 -61 -61 -61 -63 -61 
-61 -61 -61 -61 -61 -61 -61 -61 -59 -61 
-61 -61 -61 -59 -61 -59 -87 -61 -59 -59 
-61 -59 -59 -61 -59 -59 -59 -59 -59 -61 
-61 -61 -59 -59 -61 -61 -61 -61 -59 -61 
-61 -61 -61 -59 -59 -61 -61 -61 -61 -61 
-59 -61 -61 -59 -61 -59 -61 -61 -61 -61 
-61 -59 -61 -61 -61 -59 -59 -61 -61 -61 
-61 -61 -61 -61 -59 -61 -59 -61 -61 -61 
-61 -61 -59 -61 -61 -61 -61 -61 -61 -63 
-61 -61 -61 -61 -61 -61 -61 -61 -61 -61 
-61 -63 -61 -61 -61 -61 -61 -61 -61 -61 
-61 -61 -61 -61 -61 -61 -61 -61 -61 -61 
-61 -61 -61 -61 -61 -61 -61 -61 -61 -61 
-61 -61 -61 -61 -61 -61 -61 -61 -59 -61 
-61 -61 -61 -61 -61 -61 -61 -59 -61 -61 
-61 -59 -61 -59 -61 -59 -59 -59 -59 -61 
-61 -59 -59 -59 -59 -61 -61 -61 -61 -61 
-59 -61 -61 -59 -61 -61 -61 -61 -59 -59 
-61 -59 -59 -59 -61 -63 -59 -59 -61 -59 
-59 -59 -59 -61 -59 -59 -61 -59 -61 -59 
-59 -59 -59 -59 -59 -61 -61 -59 -61 -61 
-59 -59 -61 -61 -61 -61 -61 -59 -61 -61 
-61 -59 -61 -61 -61 -61 -59 -59 -61 -61 
-61 -61 -61 -59 -61 -61 -61 -61 -61 -61 
-61 -59 -61 -61 -61 -61 -61 -59 -61 -59 
-59 -61 -61 -59 -59 -61 -61 -61 -59 -61 
-59 -59 -59 -59 -59 -59 -59 -59 -59 -59 
-59 -59 -59 -59 -59 -59 -59 -59 -59 -59 
-59 -59 -61 -59 -61 -59 -59 -61 -61 -59 
-61 -59 -59 -59 -61 -59 -59 -89 -59 -59 
-59 -59 -61 -59 -59 -61 -61 -61 -61 -59 
-61 -61 -61 -59 -59 -61 -61 -61 -61 -61 
-61 -61 -59 -59 -59 -59 -59 -61 -59 -59 
-61 -59 -61 -59 -59 -59 -59 -59 -61 -59 
-59 -59 -59 -59 -59 -59 -59 -59 -59 -59 
-59 -61 -59 -57 -59 -59 -57 -57 -59 -61 
-61 -59 -59 -59 -61 -61 -59 -61 -59 -59 
-59 -59 -59 -61 -59 -61 -59 -59 -59 -59 
-61 -61 -59 -59 -59 -59 -59 -59 -59 -59 
-59 -59 -59 -59 -59 -59 -59 -59 -61 -59 
-61 -59 -59 -59 -59 -61 -61 -59 -61 -61 
-63 -61 -59 -59 -89 -61 -59 -59 -59 -59 
-61 -61 -59 -59 -61 -61 -59 -59 -59 -61 
-61 -61 -89 -61 -61 -61 -61 -61 -61 -63 
-61 -61 -61 -61 -61 -63 -61 -61 -61 -61 
-63 -61 -63 -63 -61 -65 -63 -63 -65 -63 
-65 -65 -63 -65 -63 -63 -65 -65 -65 -63 
-65 -63 -63 -65 -65 -65 -63 -65 -63 -65 
-65 -63 -63 -63 -63 -61 -63 -61 -61 -63 
-61 -61 -91 -61 -61 -61 -61 -61 -61 -61 
-61 -61 -61 -61 -59 -61 -61 -61 -61 -61 
-61 -59 -61 -61 -61 -61 -61 -61 -61 -61 
-61 -61 -61 -61 -61 -59 -61 -59 -63 -61 
-61 -61 -61 -61 -61 -59 -61 -61 -61 -61 
-61 -59 -61 -59 -61 -61 -61 -61 -59 -61 
-61 -61 -61 -57 -59 -61 -61 -61 -61 -61 
-61 -59 -59 -61 -61 -61 -61 -59 -61 -61 
-61 -61 -61 -61 -61 -61 -61 -61 -61 -59 
-61 -61 -63 -61 -63 -61 -61 -61 -59 -61 
-61 -61 -61 -59 -59 -59 -59 -61 -61 -59 
-59 -59 -61 -59 -59 -59 -61 -59 -61 -59 
-61 -61 -61 -61 -59 -61 -61 -61 -61 -59 
-59 -61 -59 -61 -61 -61 -61 -61 -61 -59 
-59 -59 -59 -59 -59 -59 -61 -59 -61 -61 
-59 -61 -59 -59 -61 -73 -75 -73 -75 -61 
-61 -61 -73 -71 -73 -59 -59 -59 -59 -61 
-59 -59 -59 -61 -61 -61 -59 -65 -61 -65 
-63 -63 -61 -67 -67 -65 -69 -67 -69 -67 
-69 -67 -65 -67 -69 -69 -69 -69 -73 -69 
-69 -69 -69 -69 -69 -71 -71 -71 -69 -69 
-69 -71 -71 -69 -71 -69 -69 -69 -67 -69 
-69 -69 -67 -67 -69 -67 -67 -67 -67 -69 
-67 -67 -65 -63 -61 -61 -59 -59 -61 -61 
-59 -61 -59 -59 -59 -59 -59 -59 -59 -59 
-61 -63 -65 -63 -65 -63 -65 -61 -61 -63 
-61 -61 -61 -61 -59 -59 -61 -59 -61 -63 
-63 -61 -61 -59 -61 -59 -61 -61 -61 -59 
-59 -61 -59 -87 -59 -59 -59 -61 -61 -61 
-61 -61 -61 -61 -61 -61 -61 -61 -61 -59 
-61 -59 -59 -59 -61 -59 -59 -61 -61 -59 
-61 -59 -59 -61 -61 -61 -61 -61 -59 -61 
