-41 -41 -39 -39 -39 -39 -39 -37 -37 -39 
-39 -37 -47 -49 -47 -49 -49 -47 -37 -39 
-39 -39 -39 -39 -39 -39 -39 -39 -39 -37 
-37 -37 -51 -53 -51 -51 -51 -49 -49 -49 
-51 -51 -53 -53 -51 -51 -51 -51 -49 -49 
-49 -49 -49 -49 -47 -47 -47 -45 -45 -45 
-43 -45 -45 -45 -45 -43 -43 -43 -43 -43 
-41 -41 -45 -47 -45 -45 -47 -49 -45 -45 
-41 -47 -45 -47 -45 -47 -47 -45 -47 -45 
-45 -45 -47 -47 -45 -45 -45 -45 -47 -47 
-45 -45 -47 -45 -47 -47 -47 -47 -47 -47 
-47 -47 -47 -47 -47 -47 -47 -47 -47 -47 
-47 -47 -47 -47 -45 -47 -47 -47 -47 -47 
-45 -47 -45 -45 -49 -49 -49 -49 -49 -49 
-53 -53 -53 -47 -47 -45 -45 -47 -47 -47 
-45 -45 -43 -43 -43 -35 -41 -43 -45 -43 
-41 -39 -41 -39 -37 -37 -41 -43 -43 -41 
-39 -31 -41 -39 -39 -39 -39 -39 -41 -39 
-39 -39 -41 -39 -39 -41 -39 -39 -39 -41 
-39 -39 -39 -39 -41 -39 -41 -39 -39 -39 
-39 -39 -39 -39 -39 -41 -41 -41 -41 -39 
-39 -39 -39 -39 -41 -41 -41 -41 -55 -51 
-43 -43 -43 -43 -53 -53 -45 -45 -43 -43 
-43 -43 -43 -43 -51 -51 -51 -55 -43 -41 
-41 -39 -39 -39 -39 -47 -49 -41 -43 -41 
-41 -41 -41 -41 -41 -43 -43 -43 -41 -41 
-41 -41 -41 -41 -41 -41 -41 -41 -41 -41 
-43 -41 -41 -41 -41 -41 -41 -41 -41 -39 
-39 -41 -39 -39 -39 -39 -39 -41 -43 -43 
-41 -41 -41 -43 -43 -45 -43 -43 -45 -45 
-45 -45 -47 -45 -45 -45 -43 -43 -43 -43 
-43 -43 -43 -43 -43 -41 -41 -41 -41 -39 
-39 -39 -39 -37 -37 -37 -37 -37 -37 -37 
-37 -37 -39 -39 -39 -39 -39 -65 -45 -47 
-45 -45 -41 -41 -41 -43 -45 -47 -47 -43 
-41 -39 -39 -39 -41 -41 -45 -45 -47 -47 
-49 -51 -47 -45 -49 -45 -45 -45 -43 -43 
-41 -43 -41 -43 -41 -41 -41 -41 -41 -41 
-41 -41 -41 -41 -41 -41 -41 -41 -41 -41 
-41 -41 -41 -41 -41 -39 -51 -43 -43 -45 
-45 -45 -43 -43 -43 -87 -43 -43 -43 -43 
-43 -43 -45 -43 -45 -45 -45 -43 -43 -45 
-45 -45 -45 -91 -45 -45 -43 -45 -45 -45 
-45 -45 -45 -45 -45 -45 -45 -45 -45 -45 
-45 -47 -45 -45 -45 -45 -45 -45 -45 -45 
-45 -45 -45 -45 -45 -45 -45 -45 -45 -45 
-45 -45 -45 -45 -45 -45 -45 -45 -45 -45 
-45 -43 -45 -43 -45 -45 -43 -45 -45 -45 
-45 -45 -45 -45 -43 -45 -45 -45 -45 -45 
-45 -45 -45 -43 -45 -45 -43 -43 -45 -43 
-43 -43 -43 -43 -43 -45 -45 -43 -43 -43 
-43 -43 -45 -43 -43 -43 -43 -43 -43 -43 
-43 -43 -43 -43 -43 -43 -47 -43 -43 -43 
-43 -43 -43 -43 -43 -43 -43 -43 -43 -43 
-43 -43 -43 -43 -41 -43 -43 -43 -43 -43 
-43 -43 -43 -41 -41 -41 -43 -41 -41 -41 
-41 -41 -41 -43 -43 -43 -41 -41 -41 -43 
-43 -43 -43 -43 -41 -43 -43 -43 -45 -45 
-45 -45 -45 -45 -45 -45 -45 -43 -45 -45 
-45 -47 -45 -45 -47 -47 -47 -45 -45 -45 
-45 -45 -51 -51 -51 -51 -51 -51 -49 -51 
-51 -49 -49 -49 -49 -49 -47 -49 -47 -47 
-47 -47 -47 -47 -51 -51 -51 -51 -51 -51 
-49 -49 -47 -47 -49 -47 -47 -47 -47 -47 
-47 -47 -47 -47 -47 -49 -55 -55 -55 -53 
-53 -51 -51 -49 -49 -49 -49 -49 -47 -45 
-91 -43 -45 -43 -43 -45 -45 -43 -43 -43 
-43 -43 -43 -43 -43 -43 -43 -41 -41 -41 
-41 -41 -41 -41 -43 -41 -41 -41 -41 -41 
-43 -43 -41 -43 -63 -43 -49 -43 -39 -39 
-43 -45 -47 -49 -45 -47 -49 -47 -47 -49 
-47 -49 -49 -49 -49 -47 -47 -49 -53 -53 
-47 -47 -47 -47 -45 -47 -49 -47 -47 -47 
-47 -47 -45 -47 -47 -49 -47 -47 -47 -47 
-47 -47 -47 -47 -47 -47 -47 -45 -49 -49 
-47 -45 -45 -45 -45 -45 -45 -45 -51 -47 
-47 -49 -47 -49 -47 -47 -43 -45 -45 -49 
-45 -47 -47 -47 -47 -47 -45 -47 -45 -49 
-45 -47 -47 -45 -47 -47 -47 -81 -81 -81 
-81 -45 -45 -45 -47 -49 -53 -53 -53 -51 
-53 -53 -53 -53 -53 -53 -53 -53 -53 -53 
-53 -53 -53 -55 -53 -55 -53 -89 -55 -53 
-53 -53 -53 -53 -53 -55 -53 -53 -53 -53 
-55 -53 -53 -53 -53 -53 -51 -45 -47 -47 
-45 -45 -45 -45 -45 -45 -45 -45 -45 -45 
-47 -45 -47 -47 -47 -47 -47 -47 -45 -45 
-45 -47 -45 -47 -47 -45 -45 -47 -47 -47 
-45 -49 -49 -45 -47 -47 -51 -51 -51 -51 
-51 -53 -49 -49 -49 -49 -47 -47 -47 -49 
-57 -43 -43 -43 -55 -47 -45 -45 -45 -45 
-45 -45 -47 -47 -43 -41 -45 -47 -45 -43 
-45 -45 -43 -43 -43 -45 -43 -47 -45 -47 
-43 -39 -39 -39 -39 -37 -37 -37 -37 -39 
-37 -37 -37 -39 -41 -39 -39 -39 -41 -39 
-39 -39 -37 -39 -39 -37 -35 -37 -37 -37 
-37 -37 -37 -37 -37 -37 -39 -37 -37 -37 
-37 -37 -37 -37 -37 -37 -37 -37 -37 -37 
-37 -37 -37 -37 -37 -37 -37 -37 -37 -39 
-37 -37 -45 -49 -45 -49 -49 -47 -47 -45 
-47 -47 -47 -47 -39 -37 -37 -37 -37 -37 
