-81 -87 -85 -87 -81 -85 -81 -81 -71 -71 
-69 -81 -83 -81 -83 -83 -67 -69 -69 -67 
-67 -67 -69 -69 -69 -69 -69 -69 -67 -69 
-69 -73 -71 -71 -71 -63 -65 -65 -65 -63 
-63 -63 -63 -65 -61 -63 -65 -65 -65 -63 
-65 -65 -65 -65 -65 -65 -63 -63 -65 -63 
-65 -65 -65 -65 -65 -65 -65 -63 -63 -63 
-63 -63 -65 -63 -65 -65 -65 -67 -65 -65 
-63 -63 -63 -63 -63 -63 -63 -61 -63 -61 
-61 -63 -63 -63 -61 -61 -63 -61 -63 -61 
-61 -61 -63 -63 -63 -63 -61 -61 -63 -63 
-63 -61 -63 -63 -65 -65 -65 -63 -65 -65 
-65 -63 -65 -63 -65 -63 -63 -63 -77 -75 
-75 -73 -73 -73 -73 -75 -75 -75 -75 -77 
-75 -77 -77 -75 -65 -65 -65 -65 -63 -65 
-65 -65 -63 -65 -65 -63 -65 -67 -67 -67 
-65 -65 -65 -67 -67 -65 -65 -67 -65 -65 
-65 -65 -65 -65 -65 -65 -65 -65 -65 -67 
-65 -65 -67 -67 -67 -67 -65 -67 -65 -65 
-65 -67 -65 -67 -65 -65 -67 -67 -67 -67 
-67 -67 -67 -67 -67 -67 -69 -67 -67 -67 
-67 -67 -67 -65 -65 -67 -65 -67 -65 -67 
-65 -67 -65 -67 -67 -63 -65 -65 -67 -67 
-67 -65 -67 -65 -67 -69 -67 -67 -69 -67 
-69 -65 -65 -61 -63 -65 -65 -63 -63 -63 
-65 -65 -65 -65 -67 -67 -65 -67 -65 -65 
-65 -65 -65 -65 -67 -67 -65 -67 -67 -67 
-67 -67 -67 -67 -67 -69 -67 -69 -67 -67 
-67 -67 -67 -67 -65 -65 -65 -65 -67 -65 
-67 -67 -65 -67 -65 -67 -69 -67 -67 -67 
-67 -69 -69 -67 -67 -67 -65 -65 -65 -65 
-65 -65 -65 -65 -65 -65 -65 -65 -67 -67 
-69 -67 -67 -67 -67 -69 -67 -67 -67 -69 
-67 -67 -67 -67 -67 -67 -69 -69 -69 -69 
-67 -69 -69 -67 -69 -69 -69 -69 -69 -67 
-67 -67 -65 -67 -65 -65 -65 -65 -65 -67 
-65 -65 -67 -67 -65 -65 -67 -67 -67 -65 
-65 -65 -65 -65 -65 -65 -63 -65 -65 -65 
-63 -65 -63 -67 -69 -69 -71 -69 -71 -67 
-67 -67 -65 -65 -63 -67 -71 -69 -69 -67 
-67 -67 -69 -69 -67 -65 -65 -63 -65 -65 
-65 -65 -65 -65 -65 -65 -65 -65 -67 -65 
-65 -67 -65 -67 -67 -67 -65 -67 -65 -65 
-67 -65 -67 -65 -65 -65 -67 -63 -65 -65 
-67 -65 -63 -65 -63 -63 -63 -63 -63 -65 
-67 -67 -69 -69 -67 -69 -67 -69 -67 -67 
-67 -67 -67 -67 -69 -69 -67 -69 -67 -67 
-67 -67 -67 -67 -67 -67 -67 -67 -67 -69 
-67 -69 -69 -67 -67 -67 -67 -67 -69 -67 
-67 -67 -67 -67 -67 -67 -67 -69 -67 -69 
-67 -67 -67 -67 -67 -67 -67 -65 -65 -65 
-65 -65 -65 -65 -69 -67 -67 -69 -67 -69 
-67 -65 -77 -75 -65 -65 -65 -63 -65 -65 
-77 -77 -65 -63 -65 -65 -65 -65 -65 -67 
-65 -65 -65 -65 -65 -65 -65 -63 -75 -79 
-67 -65 -67 -67 -65 -65 -77 -75 -63 -63 
-63 -63 -63 -63 -65 -63 -63 -63 -75 -75 
-63 -63 -65 -63 -63 -65 -65 -63 -65 -65 
-65 -65 -75 -77 -65 -65 -65 -67 -67 -65 
-67 -65 -67 -69 -65 -65 -65 -65 -65 -65 
-65 -65 -65 -65 -65 -65 -65 -67 -67 -67 
-67 -65 -65 -65 -67 -67 -67 -67 -65 -65 
-67 -65 -67 -67 -67 -67 -67 -67 -65 -65 
-65 -65 -65 -67 -65 -65 -65 -65 -65 -65 
-65 -65 -65 -65 -63 -63 -63 -63 -63 -63 
-63 -65 -63 -63 -65 -65 -65 -65 -65 -65 
-63 -63 -63 -75 -79 -73 -73 -75 -73 -63 
-65 -63 -65 -63 -63 -63 -63 -63 -63 -63 
-65 -65 -63 -67 -69 -67 -67 -67 -69 -67 
-67 -67 -67 -67 -67 -67 -65 -67 -67 -65 
-67 -67 -65 -67 -65 -65 -67 -65 -65 -65 
-65 -65 -67 -67 -67 -67 -67 -67 -67 -67 
-67 -65 -65 -65 -63 -65 -63 -65 -65 -65 
-65 -65 -63 -65 -63 -63 -63 -65 -63 -65 
-65 -63 -65 -63 -63 -65 -65 -67 -65 -67 
-65 -63 -63 -63 -63 -63 -65 -65 -65 -69 
-65 -65 -65 -65 -65 -65 -65 -63 -63 -63 
-63 -65 -67 -65 -67 -65 -65 -65 -67 -65 
-65 -65 -67 -67 -65 -67 -65 -63 -65 -65 
-65 -65 -65 -67 -65 -65 -65 -65 -65 -65 
-63 -63 -63 -63 -65 -65 -65 -65 -63 -65 
-63 -65 -65 -65 -65 -65 -65 -65 -65 -65 
-65 -65 -65 -65 -65 -63 -65 -63 -63 -65 
-73 -63 -63 -65 -65 -65 -63 -65 -65 -63 
-65 -65 -65 -61 -63 -63 -63 -65 -63 -63 
-63 -65 -63 -63 -65 -65 -63 -63 -65 -63 
-65 -65 -63 -63 -67 -65 -65 -65 -65 -65 
-63 -65 -63 -65 -65 -65 -65 -65 -65 -65 
-65 -67 -67 -67 -65 -63 -65 -63 -63 -63 
-65 -65 -63 -65 -65 -65 -65 -65 -65 -63 
-63 -63 -63 -65 -65 -67 -65 -65 -65 -63 
-65 -65 -63 -65 -65 -65 -65 -65 -65 -63 
-69 -67 -63 -65 -63 -63 -65 -65 -63 -65 
-63 -65 -63 -65 -65 -65 -69 -65 -65 -65 
-63 -63 -63 -61 -61 -61 -61 -65 -63 -65 
-63 -65 -65 -67 -67 -69 -71 -67 -69 -67 
-69 -67 -67 -67 -67 -67 -69 -69 -67 -69 
-67 -67 -69 -69 -69 -69 -69 -67 -67 -67 
-69 -69 -69 -69 -69 -69 -69 -69 -69 -67 
-69 -69 -69 -69 -69 -69 -69 -69 -69 -69 
