-47 -45 -43 -43 -43 -43 -43 -43 -43 -41 
-43 -43 -43 -43 -43 -43 -43 -43 -43 -43 
-43 -43 -43 -43 -43 -43 -47 -47 -45 -45 
-45 -45 -45 -45 -47 -45 -45 -57 -47 -59 
-57 -45 -55 -57 -59 -55 -45 -45 -47 -47 
-47 -45 -47 -47 -45 -47 -57 -59 -47 -47 
-47 -47 -47 -45 -57 -47 -47 -47 -47 -47 
-47 -47 -47 -57 -57 -47 -47 -47 -47 -47 
-47 -45 -45 -45 -47 -45 -47 -45 -45 -45 
-45 -45 -47 -47 -47 -45 -47 -47 -47 -47 
-47 -47 -47 -47 -47 -45 -47 -45 -45 -45 
-47 -47 -45 -47 -45 -45 -47 -45 -47 -45 
-47 -47 -45 -47 -47 -49 -47 -47 -45 -47 
-45 -45 -49 -47 -47 -45 -47 -45 -45 -45 
-47 -45 -45 -47 -47 -47 -45 -45 -45 -45 
-47 -47 -47 -45 -45 -45 -45 -45 -45 -45 
-45 -45 -45 -45 -45 -45 -45 -45 -47 -45 
-47 -89 -45 -45 -47 -47 -47 -45 -45 -47 
-47 -45 -45 -47 -45 -45 -47 -47 -47 -45 
-47 -45 -47 -45 -45 -45 -45 -45 -47 -45 
-47 -47 -47 -45 -45 -47 -45 -45 -45 -45 
-45 -45 -45 -45 -45 -45 -45 -45 -45 -47 
-45 -45 -45 -45 -45 -45 -45 -45 -45 -47 
-47 -45 -45 -47 -47 -45 -47 -45 -45 -47 
-47 -47 -47 -45 -45 -47 -47 -47 -47 -45 
-45 -47 -45 -47 -45 -47 -47 -47 -45 -47 
-45 -43 -47 -47 -47 -47 -47 -47 -47 -45 
-47 -47 -47 -47 -45 -45 -47 -47 -45 -47 
-45 -45 -45 -45 -45 -45 -47 -47 -47 -45 
-45 -45 -47 -45 -47 -47 -45 -45 -47 -45 
-45 -45 -47 -45 -45 -45 -53 -45 -47 -47 
-45 -45 -45 -47 -47 -45 -45 -47 -47 -47 
-45 -47 -45 -47 -45 -45 -47 -47 -45 -47 
-45 -47 -45 -45 -45 -47 -49 -45 -45 -45 
-47 -45 -49 -45 -45 -45 -47 -47 -47 -45 
-47 -47 -45 -45 -47 -45 -47 -47 -47 -47 
-91 -45 -45 -45 -89 -45 -47 -45 -45 -45 
-47 -45 -47 -45 -47 -47 -45 -49 -45 -45 
-45 -45 -47 -45 -45 -45 -45 -47 -47 -47 
-45 -45 -47 -47 -45 -47 -47 -45 -45 -47 
-47 -45 -45 -45 -45 -47 -45 -45 -45 -47 
-49 -45 -45 -45 -45 -45 -45 -45 -45 -47 
-45 -47 -47 -47 -47 -49 -47 -47 -47 -45 
-47 -47 -47 -47 -47 -47 -47 -47 -47 -47 
-45 -45 -47 -47 -45 -47 -47 -45 -45 -43 
-45 -45 -45 -45 -45 -45 -45 -43 -43 -43 
-31 -43 -45 -45 -43 -45 -45 -45 -43 -45 
-45 -43 -47 -47 -45 -45 -45 -45 -45 -45 
-43 -43 -43 -43 -45 -45 -43 -43 -45 -45 
-43 -45 -45 -45 -45 -45 -45 -43 -45 -43 
-43 -45 -45 -45 -45 -43 -43 -45 -43 -43 
-43 -43 -43 -45 -45 -45 -43 -43 -43 -43 
-45 -45 -45 -43 -43 -43 -45 -43 -47 -45 
-45 -45 -45 -45 -45 -45 -45 -43 -45 -45 
-45 -45 -45 -45 -45 -45 -45 -45 -45 -47 
-45 -45 -45 -47 -45 -47 -45 -45 -45 -45 
-45 -43 -45 -43 -43 -45 -43 -43 -43 -43 
-43 -43 -43 -43 -43 -57 -53 -51 -55 -43 
-43 -45 -57 -51 -45 -45 -45 -45 -45 -45 
-45 -45 -43 -43 -45 -43 -43 -45 -43 -43 
-45 -43 -45 -45 -47 -45 -45 -45 -47 -47 
-47 -47 -47 -47 -45 -47 -47 -45 -45 -47 
-47 -47 -45 -47 -47 -47 -47 -47 -47 -47 
-47 -47 -47 -47 -47 -47 -47 -47 -47 -47 
-47 -49 -49 -47 -47 -47 -47 -45 -45 -47 
-47 -47 -45 -43 -43 -45 -43 -43 -43 -43 
-45 -45 -45 -43 -43 -43 -43 -43 -43 -43 
-43 -43 -43 -43 -45 -43 -45 -45 -47 -47 
-45 -47 -45 -45 -45 -89 -45 -45 -45 -45 
-43 -45 -45 -45 -43 -43 -45 -43 -45 -45 
-45 -73 -43 -43 -43 -43 -45 -45 -45 -45 
-43 -45 -43 -43 -43 -43 -43 -43 -45 -43 
-45 -43 -43 -43 -43 -43 -43 -43 -45 -43 
-43 -43 -43 -45 -45 -45 -43 -43 -43 -43 
-43 -43 -43 -43 -43 -45 -43 -65 -43 -43 
-43 -45 -43 -43 -45 -43 -43 -45 -43 -43 
-43 -43 -43 -45 -45 -45 -47 -45 -45 -47 
-49 -47 -45 -47 -47 -47 -45 -47 -47 -47 
-45 -47 -49 -47 -47 -49 -47 -49 -49 -47 
-49 -47 -47 -45 -47 -47 -47 -49 -49 -49 
-49 -47 -47 -47 -47 -47 -47 -47 -47 -47 
-47 -47 -47 -47 -47 -47 -47 -47 -47 -47 
-47 -47 -47 -47 -47 -47 -47 -47 -47 -47 
-47 -47 -47 -45 -45 -45 -45 -45 -45 -45 
-43 -45 -43 -45 -43 -43 -43 -45 -43 -45 
-45 -43 -45 -45 -45 -43 -45 -43 -45 -43 
-43 -45 -45 -43 -45 -45 -45 -45 -47 -47 
-47 -45 -45 -43 -45 -47 -45 -47 -47 -45 
-45 -45 -47 -47 -45 -47 -45 -47 -45 -45 
-45 -45 -45 -43 -47 -45 -45 -45 -45 -45 
-45 -43 -45 -45 -45 -45 -45 -45 -45 -43 
-45 -45 -47 -45 -43 -45 -47 -45 -45 -47 
-45 -45 -45 -45 -45 -45 -45 -45 -47 -45 
-45 -43 -47 -45 -47 -43 -45 -45 -45 -45 
-45 -45 -43 -45 -45 -47 -45 -47 -47 -45 
-45 -45 -43 -45 -45 -43 -45 -43 -45 -47 
-45 -43 -45 -45 -45 -45 -47 -47 -45 -45 
-45 -47 -45 -45 -47 -47 -45 -47 -47 -47 
-45 -45 -47 -49 -47 -45 -47 -47 -47 -47 
-47 -47 -47 -47 -47 -45 -45 -45 -47 -45 
