-61 -61 -65 -63 -63 -65 -63 -67 -61 -63 
-61 -65 -61 -65 -65 -63 -63 -67 -65 -65 
-65 -63 -63 -61 -61 -79 -63 -63 -73 -77 
-79 -77 -63 -63 -63 -63 -63 -63 -65 -63 
-63 -63 -65 -63 -63 -63 -63 -65 -65 -63 
-63 -73 -73 -65 -63 -63 -63 -63 -63 -65 
-63 -63 -63 -65 -63 -65 -67 -67 -67 -65 
-69 -67 -67 -69 -67 -67 -69 -67 -69 -67 
-67 -65 -65 -63 -63 -63 -61 -61 -61 -61 
-61 -61 -59 -61 -61 -61 -59 -59 -59 -59 
-61 -61 -59 -61 -59 -61 -61 -61 -59 -59 
-61 -59 -59 -61 -61 -59 -59 -61 -61 -61 
-61 -61 -61 -61 -61 -61 -61 -61 -61 -61 
-61 -61 -61 -63 -63 -63 -63 -63 -63 -63 
-63 -63 -65 -67 -67 -67 -69 -69 -69 -69 
-69 -69 -69 -69 -69 -67 -69 -69 -67 -67 
-67 -67 -65 -65 -65 -65 -65 -63 -65 -65 
-63 -65 -65 -65 -65 -65 -65 -67 -65 -67 
-69 -69 -69 -69 -69 -67 -69 -67 -67 -67 
-67 -67 -67 -67 -67 -67 -67 -65 -65 -63 
-65 -65 -65 -65 -65 -67 -65 -67 -67 -69 
-67 -67 -65 -65 -67 -67 -67 -67 -69 -69 
-69 -69 -69 -69 -69 -67 -67 -67 -67 -67 
-67 -67 -67 -67 -67 -67 -69 -69 -69 -69 
-69 -69 -65 -63 -61 -61 -61 -61 -61 -61 
-63 -61 -61 -63 -63 -61 -65 -65 -67 -67 
-69 -65 -65 -63 -65 -65 -65 -65 -63 -63 
-61 -65 -63 -65 -63 -63 -69 -65 -65 -73 
-73 -71 -73 -71 -71 -71 -91 -71 -73 -71 
-73 -73 -73 -73 -73 -73 -73 -71 -69 -67 
-67 -65 -65 -63 -61 -61 -61 -61 -63 -63 
-63 -63 -63 -63 -63 -63 -63 -63 -65 -69 
-63 -61 -61 -61 -61 -61 -61 -61 -61 -63 
-63 -61 -61 -61 -61 -61 -61 -59 -61 -65 
-65 -67 -67 -65 -65 -67 -67 -67 -69 -67 
-67 -69 -69 -69 -67 -67 -67 -67 -67 -67 
-67 -65 -67 -67 -67 -67 -67 -67 -67 -67 
-67 -67 -67 -67 -67 -69 -69 -69 -71 -69 
-69 -71 -69 -69 -69 -69 -67 -67 -69 -67 
-67 -69 -69 -69 -65 -65 -67 -67 -67 -67 
-67 -67 -69 -67 -69 -69 -69 -67 -67 -67 
-69 -69 -69 -67 -67 -67 -69 -69 -69 -67 
-69 -67 -67 -67 -67 -67 -67 -67 -67 -65 
-67 -67 -67 -67 -67 -65 -67 -67 -67 -67 
-67 -67 -67 -91 -67 -67 -67 -67 -67 -67 
-65 -67 -65 -65 -67 -67 -67 -67 -67 -67 
-65 -67 -65 -67 -65 -65 -67 -67 -67 -67 
-67 -67 -67 -65 -67 -67 -67 -67 -65 -67 
-67 -65 -67 -65 -65 -65 -67 -65 -67 -65 
-67 -65 -65 -65 -65 -67 -65 -65 -65 -65 
-65 -67 -65 -65 -65 -65 -67 -65 -65 -67 
-65 -67 -67 -67 -67 -69 -67 -69 -69 -67 
-67 -69 -67 -67 -67 -67 -67 -67 -67 -67 
-67 -67 -67 -65 -67 -67 -65 -65 -67 -65 
-67 -65 -67 -65 -67 -67 -67 -67 -67 -67 
-67 -67 -67 -67 -67 -67 -69 -67 -67 -67 
-67 -67 -67 -67 -67 -67 -67 -65 -67 -69 
-67 -67 -69 -69 -69 -69 -69 -69 -69 -69 
-69 -69 -69 -67 -67 -67 -67 -67 -69 -67 
-69 -67 -67 -67 -67 -65 -65 -65 -67 -65 
-65 -67 -65 -91 -67 -65 -65 -67 -65 -65 
-67 -65 -67 -65 -67 -67 -67 -67 -67 -65 
-67 -67 -67 -67 -67 -67 -67 -67 -67 -65 
-67 -65 -67 -67 -69 -67 -67 -65 -65 -65 
-63 -65 -65 -67 -67 -67 -65 -67 -67 -67 
-67 -67 -67 -67 -67 -67 -67 -69 -69 -91 
-69 -69 -69 -67 -67 -67 -67 -67 -69 -67 
-67 -67 -67 -91 -67 -67 -65 -67 -67 -65 
-65 -65 -65 -65 -65 -63 -63 -65 -63 -63 
-63 -63 -65 -65 -65 -65 -65 -65 -65 -65 
-67 -67 -65 -67 -67 -67 -67 -65 -65 -67 
-67 -67 -87 -65 -65 -67 -67 -67 -65 -67 
-67 -67 -67 -67 -69 -67 -67 -67 -67 -67 
-67 -65 -65 -67 -67 -65 -67 -67 -65 -65 
-65 -67 -65 -67 -65 -65 -65 -65 -65 -65 
-65 -65 -65 -65 -67 -65 -67 -67 -67 -65 
-65 -67 -67 -65 -63 -63 -63 -65 -65 -67 
-65 -67 -67 -67 -67 -65 -65 -65 -65 -65 
-67 -63 -63 -63 -61 -61 -63 -61 -61 -61 
-61 -63 -63 -65 -65 -65 -65 -65 -61 -61 
-63 -61 -61 -63 -67 -67 -67 -65 -65 -65 
-67 -67 -65 -65 -65 -67 -65 -65 -67 -67 
-67 -67 -67 -67 -67 -67 -69 -69 -69 -69 
-69 -67 -67 -69 -67 -67 -67 -67 -69 -67 
-67 -67 -67 -67 -67 -67 -67 -67 -67 -67 
-65 -67 -67 -67 -65 -67 -67 -65 -67 -67 
-69 -69 -69 -69 -67 -65 -65 -65 -67 -65 
-67 -67 -67 -67 -65 -65 -67 -67 -65 -67 
-69 -71 -69 -69 -67 -67 -67 -69 -69 -69 
-69 -67 -69 -67 -69 -69 -69 -69 -69 -69 
-69 -67 -69 -69 -67 -67 -67 -67 -67 -67 
-67 -67 -69 -69 -67 -67 -67 -67 -67 -67 
-67 -67 -67 -67 -67 -67 -67 -69 -67 -69 
-69 -67 -69 -69 -69 -71 -69 -71 -73 -71 
-71 -71 -69 -69 -71 -69 -69 -69 -69 -71 
-69 -69 -69 -69 -69 -69 -69 -69 -69 -69 
-69 -69 -71 -69 -69 -69 -71 -69 -69 -69 
-69 -69 -69 -69 -69 -69 -69 -69 -69 -69 
-71 -71 -69 -69 -69 -71 -69 -71 -71 -71 
-69 -71 -69 -69 -71 -71 -71 -71 -71 -71 
