-39 -39 -39 -49 -49 -47 -49 -49 -49 -39 
-39 -39 -37 -83 -37 -39 -39 -39 -39 -39 
-91 -39 -39 -39 -39 -39 -39 -39 -49 -49 
-49 -49 -47 -49 -49 -47 -37 -39 -39 -49 
-47 -51 -49 -45 -39 -39 -39 -39 -39 -39 
-39 -39 -39 -39 -39 -39 -39 -39 -39 -39 
-39 -39 -35 -35 -35 -35 -35 -35 -35 -35 
-35 -35 -35 -33 -35 -35 -35 -33 -35 -35 
-35 -35 -35 -35 -35 -35 -37 -35 -35 -35 
-35 -35 -35 -33 -35 -35 -33 -35 -35 -33 
-35 -33 -33 -33 -35 -35 -33 -33 -33 -33 
-33 -33 -89 -33 -33 -33 -33 -33 -33 -35 
-35 -35 -35 -35 -35 -35 -35 -35 -35 -35 
-33 -33 -33 -35 -33 -33 -33 -33 -33 -33 
-33 -33 -33 -33 -33 -33 -33 -33 -33 -33 
-33 -33 -33 -31 -33 -33 -33 -33 -33 -33 
-33 -33 -35 -35 -35 -37 -37 -37 -37 -37 
-37 -37 -35 -35 -35 -91 -35 -35 -35 -35 
-35 -37 -37 -37 -37 -37 -37 -37 -37 -37 
-37 -37 -37 -37 -39 -39 -39 -37 -37 -39 
-39 -39 -39 -37 -37 -37 -37 -37 -37 -37 
-37 -37 -37 -37 -37 -37 -37 -39 -39 -39 
-41 -53 -53 -53 -51 -49 -47 -47 -45 -45 
-47 -47 -45 -45 -45 -45 -43 -55 -51 -51 
-51 -49 -49 -51 -51 -49 -51 -51 -51 -51 
-49 -49 -47 -47 -47 -49 -49 -91 -49 -49 
-51 -49 -51 -51 -51 -53 -51 -51 -45 -45 
-47 -45 -45 -45 -47 -45 -45 -45 -45 -45 
-45 -45 -45 -43 -43 -43 -43 -43 -43 -43 
-43 -43 -43 -43 -43 -43 -43 -43 -43 -43 
-43 -43 -41 -43 -41 -41 -41 -43 -41 -43 
-91 -43 -43 -43 -43 -43 -43 -43 -43 -43 
-43 -43 -43 -45 -45 -51 -51 -57 -55 -55 
-55 -53 -53 -57 -53 -51 -43 -55 -45 -49 
-47 -47 -45 -43 -43 -45 -45 -43 -45 -49 
-53 -45 -45 -45 -45 -45 -45 -43 -45 -45 
-43 -45 -45 -47 -43 -49 -51 -47 -53 -53 
-53 -51 -53 -45 -45 -45 -43 -45 -43 -43 
-43 -43 -45 -45 -45 -45 -45 -49 -47 -47 
-45 -43 -45 -45 -45 -47 -45 -45 -45 -45 
-45 -45 -45 -45 -45 -45 -45 -45 -45 -47 
-47 -47 -45 -45 -45 -45 -45 -45 -47 -47 
-45 -45 -45 -45 -45 -47 -47 -45 -45 -47 
-45 -45 -45 -45 -45 -45 -45 -45 -47 -45 
-47 -45 -43 -47 -45 -45 -45 -45 -45 -45 
-43 -45 -45 -45 -45 -45 -45 -45 -45 -45 
-45 -45 -45 -45 -45 -45 -45 -47 -45 -45 
-45 -45 -45 -47 -47 -49 -49 -49 -49 -49 
-49 -49 -49 -49 -49 -51 -51 -51 -49 -51 
-51 -53 -55 -57 -59 -59 -59 -45 -45 -45 
-45 -45 -45 -43 -43 -41 -41 -41 -41 -43 
-43 -47 -45 -45 -45 -45 -47 -45 -47 -45 
-45 -45 -41 -45 -45 -43 -41 -41 -41 -43 
-43 -43 -41 -41 -41 -41 -41 -41 -41 -43 
-43 -47 -45 -45 -47 -47 -47 -53 -47 -43 
-43 -43 -43 -45 -49 -51 -51 -45 -47 -43 
-43 -43 -47 -47 -45 -45 -47 -45 -47 -47 
-49 -49 -47 -47 -47 -47 -49 -49 -49 -49 
-51 -51 -53 -53 -53 -51 -49 -49 -49 -49 
-49 -45 -45 -45 -45 -45 -45 -45 -91 -45 
-45 -45 -45 -45 -47 -45 -47 -49 -49 -57 
-59 -55 -49 -49 -51 -49 -51 -51 -51 -51 
-47 -47 -47 -51 -53 -45 -45 -45 -43 -43 
-45 -45 -43 -47 -49 -49 -49 -49 -49 -49 
-49 -51 -51 -49 -49 -47 -45 -47 -45 -45 
-45 -45 -45 -47 -45 -45 -47 -47 -49 -47 
-47 -47 -45 -45 -45 -45 -45 -47 -51 -49 
-47 -47 -49 -49 -49 -49 -51 -49 -51 -53 
-53 -53 -51 -53 -53 -53 -53 -53 -53 -53 
-53 -51 -51 -51 -51 -49 -49 -45 -43 -43 
-43 -43 -47 -47 -45 -45 -45 -45 -45 -49 
-47 -47 -45 -45 -45 -45 -49 -51 -51 -49 
-51 -51 -51 -51 -49 -49 -49 -49 -49 -43 
-41 -39 -45 -49 -51 -49 -47 -47 -49 -47 
-43 -47 -43 -39 -39 -39 -39 -41 -55 -55 
-43 -43 -43 -45 -45 -45 -59 -59 -47 -47 
-45 -89 -45 -45 -45 -45 -45 -45 -45 -45 
-43 -43 -43 -43 -51 -51 -41 -41 -41 -41 
-41 -41 -55 -57 -45 -45 -47 -45 -47 -47 
-47 -47 -47 -91 -61 -53 -41 -41 -41 -41 
-41 -41 -41 -41 -41 -41 -41 -41 -39 -49 
-53 -41 -41 -41 -41 -41 -43 -45 -45 -45 
-47 -45 -47 -47 -47 -49 -49 -49 -49 -49 
-47 -43 -43 -43 -43 -41 -41 -41 -41 -39 
-39 -39 -39 -39 -39 -39 -39 -39 -39 -39 
-39 -39 -39 -37 -39 -37 -39 -37 -39 -39 
-39 -39 -39 -39 -39 -39 -39 -39 -39 -39 
-39 -41 -41 -41 -41 -41 -41 -41 -41 -43 
-41 -41 -91 -39 -43 -43 -43 -45 -45 -45 
-45 -45 -45 -47 -47 -47 -47 -47 -49 -47 
-49 -47 -49 -49 -49 -49 -51 -49 -51 -49 
-51 -51 -49 -51 -49 -47 -47 -47 -45 -45 
-47 -47 -45 -45 -45 -45 -45 -45 -45 -47 
-45 -45 -45 -45 -45 -45 -45 -43 -43 -43 
-43 -43 -43 -43 -41 -41 -41 -41 -41 -39 
-39 -39 -39 -39 -39 -39 -39 -39 -41 -41 
-41 -39 -41 -41 -41 -41 -41 -41 -41 -39 
-41 -41 -41 -41 -41 -41 -41 -39 -39 -39 
-39 -39 -39 -39 -39 -39 -39 -39 -39 -39 
-39 -39 -39 -39 -41 -41 -41 -41 -41 -41 
