-57 -63 -61 -61 -57 -61 -59 -57 -57 -61 
-61 -63 -59 -61 -61 -59 -61 -63 -61 -59 
-59 -77 -79 -69 -65 -75 -77 -81 -79 -65 
-63 -63 -67 -69 -67 -67 -67 -67 -67 -69 
-69 -65 -65 -65 -67 -69 -69 -65 -67 -79 
-77 -55 -55 -57 -55 -57 -57 -57 -55 -57 
-59 -59 -59 -59 -57 -57 -57 -55 -55 -57 
-57 -55 -57 -57 -57 -57 -91 -55 -55 -57 
-57 -55 -55 -59 -59 -59 -65 -65 -67 -57 
-57 -57 -57 -57 -57 -59 -57 -57 -59 -57 
-59 -57 -59 -57 -57 -59 -57 -59 -57 -59 
-57 -57 -59 -57 -59 -59 -63 -61 -61 -59 
-69 -69 -69 -63 -69 -71 -71 -69 -69 -69 
-71 -69 -69 -67 -69 -69 -65 -63 -63 -61 
-57 -57 -61 -57 -57 -55 -55 -57 -55 -65 
-65 -63 -63 -63 -63 -79 -55 -55 -57 -55 
-57 -59 -59 -57 -59 -61 -61 -61 -67 -69 
-67 -65 -63 -63 -63 -63 -63 -63 -61 -61 
-61 -63 -63 -63 -69 -67 -67 -67 -69 -67 
-65 -63 -63 -61 -61 -61 -61 -61 -59 -57 
-57 -57 -57 -57 -57 -55 -57 -55 -55 -55 
-55 -57 -55 -55 -53 -53 -53 -51 -53 -53 
-53 -53 -53 -55 -89 -55 -59 -59 -57 -57 
-57 -57 -57 -57 -57 -57 -57 -59 -57 -59 
-59 -57 -57 -57 -57 -57 -55 -57 -57 -57 
-57 -59 -61 -59 -59 -61 -61 -63 -61 -57 
-57 -61 -63 -65 -67 -67 -63 -65 -61 -63 
-63 -63 -65 -63 -65 -65 -65 -65 -65 -65 
-63 -65 -65 -65 -65 -63 -65 -65 -65 -65 
-65 -65 -65 -65 -63 -63 -63 -65 -65 -67 
-65 -67 -69 -69 -65 -65 -63 -61 -63 -61 
-61 -63 -63 -63 -63 -63 -63 -63 -63 -63 
-63 -63 -65 -63 -63 -63 -65 -49 -49 -49 
-67 -65 -65 -65 -65 -65 -65 -65 -65 -65 
-63 -65 -65 -65 -65 -65 -63 -63 -63 -65 
-65 -63 -63 -65 -59 -59 -61 -61 -61 -61 
-61 -61 -61 -61 -61 -61 -61 -61 -61 -61 
-61 -61 -63 -61 -61 -61 -61 -63 -61 -61 
-61 -61 -61 -63 -61 -63 -61 -63 -61 -63 
-63 -63 -63 -63 -63 -63 -65 -63 -67 -65 
-65 -65 -67 -67 -65 -65 -67 -67 -67 -67 
-67 -67 -67 -67 -65 -67 -67 -65 -65 -65 
-65 -63 -65 -63 -65 -65 -65 -65 -65 -63 
-63 -63 -63 -63 -63 -63 -63 -63 -63 -61 
-61 -63 -61 -61 -63 -63 -63 -61 -63 -63 
-63 -61 -63 -63 -63 -63 -63 -65 -65 -65 
-65 -67 -65 -67 -67 -67 -65 -67 -55 -55 
-55 -65 -65 -65 -67 -67 -69 -67 -67 -67 
-65 -67 -65 -65 -65 -65 -65 -63 -61 -59 
-59 -59 -61 -61 -61 -61 -61 -61 -61 -61 
-61 -61 -63 -61 -63 -61 -63 -63 -63 -65 
-65 -63 -63 -65 -63 -63 -61 -59 -57 -57 
-65 -61 -63 -59 -59 -55 -55 -57 -55 -55 
-59 -61 -59 -59 -55 -55 -57 -57 -61 -61 
-63 -63 -59 -59 -59 -57 -59 -55 -59 -61 
-61 -63 -59 -69 -55 -55 -55 -53 -59 -55 
-55 -55 -55 -55 -55 -53 -55 -55 -55 -55 
-55 -89 -55 -55 -55 -55 -55 -55 -55 -55 
-55 -57 -55 -55 -55 -55 -55 -55 -55 -53 
-55 -53 -55 -53 -53 -53 -55 -55 -55 -57 
-57 -57 -55 -57 -55 -55 -55 -55 -55 -55 
-55 -55 -55 -55 -55 -55 -55 -55 -57 -57 
-55 -55 -55 -55 -57 -55 -55 -57 -55 -55 
-55 -57 -57 -57 -55 -55 -55 -55 -55 -57 
-57 -57 -55 -57 -57 -55 -55 -55 -55 -57 
-55 -55 -55 -55 -55 -55 -57 -57 -55 -55 
-57 -57 -55 -55 -55 -55 -57 -55 -57 -55 
-55 -47 -55 -55 -57 -55 -55 -55 -55 -55 
-57 -59 -59 -57 -57 -57 -57 -57 -57 -57 
-59 -59 -57 -57 -57 -57 -57 -57 -55 -55 
-57 -57 -55 -53 -53 -53 -53 -67 -65 -55 
-57 -57 -59 -57 -57 -57 -57 -57 -55 -55 
-57 -55 -55 -55 -55 -55 -67 -67 -57 -55 
-55 -53 -55 -53 -55 -53 -53 -57 -55 -55 
-69 -67 -55 -57 -57 -57 -55 -55 -55 -55 
-57 -65 -65 -55 -57 -55 -55 -55 -57 -55 
-55 -57 -57 -57 -55 -55 -57 -55 -57 -55 
-65 -67 -57 -55 -55 -57 -91 -55 -55 -57 
-55 -53 -55 -55 -55 -55 -53 -53 -55 -55 
-53 -55 -53 -55 -53 -55 -55 -55 -53 -55 
-55 -55 -53 -53 -55 -51 -53 -55 -53 -53 
-53 -53 -53 -55 -53 -55 -57 -53 -53 -55 
-53 -53 -53 -55 -55 -55 -53 -55 -53 -53 
-55 -53 -55 -55 -55 -53 -53 -53 -55 -55 
-55 -53 -53 -55 -55 -55 -53 -55 -53 -53 
-53 -55 -55 -55 -55 -55 -55 -55 -55 -55 
-53 -53 -53 -55 -55 -53 -55 -55 -55 -55 
-55 -55 -53 -55 -53 -53 -55 -55 -55 -53 
-53 -53 -53 -57 -57 -55 -55 -53 -59 -59 
-59 -59 -59 -59 -59 -59 -59 -57 -59 -61 
-59 -59 -57 -59 -57 -59 -59 -59 -67 -59 
-59 -59 -57 -59 -59 -57 -57 -57 -57 -57 
-59 -59 -57 -57 -59 -59 -57 -57 -57 -57 
-59 -59 -57 -59 -59 -59 -59 -57 -57 -59 
-57 -59 -57 -59 -59 -63 -59 -59 -59 -59 
-59 -59 -59 -59 -59 -57 -59 -57 -57 -57 
-57 -57 -57 -57 -57 -55 -57 -55 -55 -57 
-55 -55 -55 -55 -57 -55 -57 -57 -57 -57 
-55 -55 -55 -55 -55 -55 -55 -53 -53 -53 
-53 -53 -55 -55 -55 -55 -55 -53 -53 -53 
