-41 -41 -39 -41 -39 -39 -39 -39 -39 -39 
-39 -43 -43 -43 -41 -39 -41 -45 -45 -45 
-45 -61 -45 -45 -45 -57 -45 -59 -55 -55 
-55 -57 -55 -45 -45 -47 -45 -47 -45 -47 
-45 -47 -45 -57 -57 -47 -45 -47 -47 -47 
-57 -47 -47 -45 -47 -45 -45 -47 -45 -57 
-45 -47 -45 -45 -45 -45 -45 -45 -43 -45 
-45 -45 -45 -45 -45 -43 -45 -45 -45 -45 
-45 -45 -45 -47 -47 -47 -45 -47 -47 -45 
-45 -47 -47 -45 -45 -45 -45 -47 -47 -45 
-45 -47 -47 -47 -45 -45 -45 -47 -47 -47 
-45 -45 -47 -45 -47 -45 -47 -45 -47 -45 
-47 -45 -45 -45 -45 -45 -45 -45 -45 -45 
-45 -43 -45 -45 -45 -45 -45 -45 -45 -47 
-45 -45 -45 -45 -45 -45 -45 -45 -45 -45 
-45 -45 -45 -45 -45 -45 -45 -45 -45 -45 
-45 -45 -43 -45 -45 -45 -45 -45 -45 -45 
-45 -45 -45 -43 -45 -45 -45 -43 -43 -43 
-43 -45 -43 -43 -43 -43 -43 -43 -43 -43 
-45 -45 -45 -45 -45 -45 -45 -45 -45 -45 
-45 -45 -45 -43 -43 -43 -45 -45 -45 -45 
-45 -45 -45 -43 -43 -45 -45 -45 -45 -43 
-45 -45 -45 -45 -45 -45 -45 -45 -45 -45 
-45 -45 -43 -43 -43 -45 -45 -45 -91 -45 
-45 -45 -45 -43 -45 -45 -45 -45 -45 -43 
-43 -43 -43 -43 -43 -43 -43 -43 -43 -43 
-45 -45 -45 -45 -43 -45 -45 -43 -45 -43 
-45 -45 -45 -45 -43 -45 -45 -45 -45 -45 
-45 -45 -45 -45 -45 -45 -45 -45 -47 -45 
-45 -45 -45 -45 -45 -45 -45 -45 -45 -45 
-45 -91 -43 -45 -45 -43 -45 -45 -45 -45 
-45 -45 -45 -45 -45 -45 -45 -45 -45 -45 
-45 -45 -45 -45 -45 -47 -45 -45 -45 -45 
-45 -43 -45 -45 -45 -45 -43 -45 -43 -45 
-43 -45 -45 -43 -91 -89 -45 -45 -45 -45 
-45 -45 -45 -45 -35 -45 -45 -45 -43 -45 
-45 -45 -45 -43 -45 -45 -45 -45 -45 -45 
-45 -43 -45 -43 -43 -43 -43 -45 -43 -45 
-43 -45 -45 -45 -45 -43 -43 -45 -45 -45 
-45 -45 -43 -45 -43 -45 -43 -43 -43 -43 
-43 -45 -43 -45 -43 -43 -43 -43 -43 -45 
-45 -45 -45 -45 -45 -45 -45 -45 -45 -45 
-45 -45 -45 -45 -45 -45 -45 -45 -45 -45 
-45 -45 -45 -45 -45 -45 -87 -39 -39 -39 
-39 -41 -41 -41 -41 -41 -41 -41 -41 -41 
-39 -41 -33 -41 -41 -41 -41 -41 -41 -41 
-41 -41 -41 -41 -41 -39 -41 -41 -41 -41 
-41 -43 -43 -43 -43 -41 -41 -41 -41 -41 
-41 -41 -41 -41 -41 -41 -39 -39 -39 -41 
-39 -41 -41 -39 -39 -41 -91 -49 -55 -49 
-51 -39 -41 -41 -51 -53 -51 -51 -41 -39 
-39 -39 -39 -39 -41 -39 -41 -41 -41 -43 
-41 -43 -43 -43 -43 -43 -43 -45 -43 -43 
-43 -43 -43 -45 -45 -45 -43 -45 -45 -45 
-45 -43 -43 -45 -43 -43 -45 -43 -43 -43 
-43 -45 -45 -43 -43 -43 -45 -45 -45 -43 
-43 -43 -43 -43 -43 -43 -43 -43 -43 -43 
-45 -43 -43 -43 -43 -43 -43 -43 -45 -45 
-43 -43 -45 -43 -43 -43 -43 -45 -41 -91 
-41 -61 -41 -41 -41 -41 -41 -41 -41 -41 
-41 -41 -41 -41 -41 -41 -41 -41 -41 -41 
-87 -41 -41 -39 -41 -39 -39 -39 -39 -39 
-39 -39 -41 -39 -41 -39 -41 -41 -41 -41 
-41 -41 -39 -39 -39 -39 -39 -41 -39 -41 
-41 -41 -41 -41 -41 -41 -43 -43 -43 -41 
-43 -43 -43 -43 -43 -41 -43 -43 -43 -43 
-43 -43 -43 -43 -43 -43 -43 -43 -43 -43 
-43 -43 -45 -43 -43 -43 -43 -43 -43 -43 
-91 -41 -43 -43 -41 -41 -41 -41 -41 -41 
-41 -41 -39 -39 -39 -39 -39 -39 -39 -39 
-39 -39 -39 -39 -41 -39 -41 -41 -43 -43 
-43 -43 -43 -43 -43 -43 -43 -43 -43 -43 
-43 -43 -43 -43 -43 -43 -43 -43 -43 -45 
-43 -43 -45 -43 -45 -43 -43 -45 -45 -43 
-43 -43 -43 -87 -45 -45 -43 -43 -45 -43 
-45 -45 -45 -45 -43 -45 -45 -45 -43 -43 
-43 -43 -43 -43 -43 -43 -43 -43 -43 -43 
-43 -43 -43 -43 -45 -43 -35 -43 -43 -43 
-43 -43 -43 -43 -43 -43 -43 -43 -43 -43 
-45 -43 -45 -85 -43 -45 -43 -41 -43 -43 
-43 -45 -43 -43 -43 -43 -43 -43 -43 -43 
-43 -43 -43 -41 -43 -43 -45 -43 -45 -43 
-43 -45 -43 -43 -45 -45 -43 -45 -43 -43 
-45 -43 -43 -45 -43 -43 -45 -43 -43 -43 
-45 -43 -43 -43 -43 -43 -43 -43 -43 -43 
-43 -43 -91 -45 -45 -45 -43 -43 -43 -43 
-43 -43 -41 -41 -41 -43 -41 -41 -91 -39 
-39 -39 -39 -39 -41 -41 -41 -41 -41 -41 
-39 -41 -41 -41 -41 -41 -41 -41 -41 -41 
-41 -39 -41 -41 -41 -43 -41 -43 -45 -43 
-43 -43 -45 -43 -43 -43 -43 -43 -43 -45 
-45 -43 -43 -45 -45 -43 -43 -43 -43 -43 
-43 -43 -43 -43 -43 -43 -43 -43 -43 -43 
-43 -43 -45 -45 -43 -43 -43 -43 -45 -45 
-43 -43 -43 -43 -43 -43 -43 -45 -45 -43 
-43 -43 -45 -43 -43 -45 -43 -45 -91 -43 
-45 -43 -45 -45 -43 -43 -43 -43 -43 -43 
-43 -43 -43 -43 -45 -43 -43 -45 -45 -43 
-43 -43 -43 -41 -41 -41 -41 -41 -41 -39 
-39 -41 -41 -39 -73 -41 -43 -43 -43 -41 
