-57 -57 -55 -63 -65 -65 -67 -65 -61 -53 
-51 -51 -53 -55 -53 -55 -55 -53 -51 -53 
-53 -51 -51 -53 -53 -53 -53 -53 -63 -67 
-67 -65 -65 -67 -65 -65 -53 -55 -53 -65 
-65 -65 -69 -63 -63 -55 -57 -55 -55 -55 
-57 -55 -57 -55 -57 -55 -57 -57 -57 -57 
-55 -55 -53 -53 -55 -55 -55 -55 -89 -57 
-57 -57 -57 -57 -57 -57 -55 -55 -55 -55 
-55 -55 -55 -55 -55 -53 -55 -55 -55 -53 
-55 -55 -55 -55 -55 -55 -55 -55 -55 -57 
-55 -57 -55 -57 -57 -55 -55 -55 -53 -55 
-57 -55 -55 -55 -55 -55 -55 -55 -55 -55 
-55 -55 -57 -55 -55 -55 -55 -55 -57 -55 
-55 -55 -55 -55 -55 -55 -57 -57 -55 -55 
-57 -55 -57 -57 -55 -55 -55 -55 -53 -51 
-51 -51 -51 -51 -51 -51 -51 -49 -51 -55 
-55 -55 -55 -55 -55 -57 -55 -55 -57 -57 
-57 -57 -57 -57 -57 -57 -57 -57 -57 -57 
-57 -57 -57 -55 -57 -57 -55 -55 -55 -57 
-57 -57 -57 -59 -59 -59 -71 -59 -63 -63 
-59 -59 -57 -57 -57 -61 -61 -61 -61 -61 
-61 -61 -59 -59 -61 -59 -59 -61 -61 -63 
-59 -57 -57 -57 -57 -57 -59 -59 -59 -59 
-59 -59 -61 -59 -59 -59 -61 -59 -59 -59 
-59 -59 -61 -63 -61 -61 -59 -61 -59 -59 
-59 -57 -59 -59 -59 -59 -59 -59 -59 -61 
-63 -63 -61 -63 -61 -59 -61 -59 -61 -57 
-57 -57 -57 -59 -59 -61 -63 -63 -61 -63 
-63 -63 -63 -65 -65 -63 -61 -67 -67 -65 
-63 -57 -63 -63 -63 -61 -63 -63 -63 -61 
-63 -61 -63 -61 -61 -63 -61 -59 -63 -63 
-61 -61 -63 -61 -61 -63 -63 -63 -63 -63 
-63 -63 -59 -59 -59 -57 -59 -61 -61 -61 
-61 -61 -61 -61 -61 -61 -61 -61 -61 -61 
-61 -63 -63 -61 -61 -63 -63 -63 -61 -63 
-61 -63 -63 -63 -63 -63 -61 -63 -63 -63 
-61 -61 -59 -59 -57 -57 -59 -59 -59 -59 
-59 -61 -61 -61 -61 -61 -61 -59 -61 -61 
-57 -57 -59 -57 -59 -57 -59 -59 -59 -59 
-59 -59 -59 -59 -85 -59 -59 -59 -59 -59 
-61 -59 -61 -59 -61 -61 -61 -61 -61 -59 
-61 -59 -59 -59 -57 -59 -57 -59 -57 -57 
-57 -57 -57 -57 -57 -57 -57 -57 -57 -57 
-57 -57 -59 -63 -63 -63 -61 -63 -61 -63 
-65 -65 -65 -65 -65 -65 -61 -61 -57 -61 
-61 -61 -59 -61 -61 -61 -61 -61 -63 -63 
-61 -61 -63 -61 -61 -61 -61 -61 -63 -61 
-61 -61 -61 -61 -61 -61 -61 -59 -61 -61 
-63 -91 -63 -63 -61 -61 -63 -61 -61 -61 
-61 -61 -63 -61 -61 -59 -59 -59 -57 -59 
-59 -57 -57 -59 -59 -59 -57 -57 -59 -57 
-59 -59 -57 -57 -59 -59 -59 -59 -59 -57 
-57 -59 -57 -59 -57 -59 -59 -57 -59 -59 
-59 -57 -57 -89 -63 -65 -61 -61 -61 -61 
-61 -89 -61 -63 -63 -63 -61 -63 -59 -61 
-61 -91 -91 -91 -91 -57 -57 -57 -55 -55 
-67 -67 -55 -55 -55 -57 -57 -57 -57 -57 
-57 -57 -57 -59 -59 -57 -57 -65 -65 -89 
-89 -59 -59 -59 -57 -57 -59 -59 -57 -57 
-57 -57 -59 -59 -57 -59 -57 -59 -59 -59 
-59 -59 -61 -59 -59 -59 -59 -61 -59 -59 
-59 -59 -59 -61 -59 -59 -59 -59 -59 -59 
-59 -59 -59 -59 -61 -61 -59 -59 -61 -61 
-59 -61 -61 -61 -63 -61 -61 -61 -61 -61 
-61 -61 -61 -61 -61 -63 -63 -61 -61 -61 
-63 -61 -63 -61 -61 -63 -63 -63 -63 -63 
-61 -63 -61 -63 -61 -61 -61 -63 -63 -63 
-63 -63 -63 -63 -63 -63 -65 -63 -63 -63 
-63 -63 -91 -65 -63 -63 -63 -63 -63 -65 
-65 -63 -63 -63 -63 -63 -63 -63 -63 -63 
-61 -63 -63 -61 -63 -63 -63 -61 -63 -61 
-61 -61 -61 -61 -61 -61 -61 -61 -61 -61 
-61 -61 -63 -61 -63 -61 -61 -61 -61 -61 
-61 -63 -63 -63 -61 -61 -61 -61 -61 -63 
-61 -63 -61 -61 -61 -63 -63 -61 -63 -63 
-63 -63 -63 -63 -63 -63 -61 -63 -61 -87 
-63 -63 -63 -63 -63 -63 -61 -63 -63 -63 
-63 -63 -65 -63 -65 -65 -65 -63 -65 -65 
-65 -65 -63 -63 -61 -61 -61 -61 -61 -61 
-59 -59 -59 -57 -57 -57 -57 -57 -55 -57 
-55 -57 -55 -57 -55 -55 -57 -61 -63 -61 
-61 -59 -61 -61 -63 -59 -61 -67 -65 -55 
-55 -55 -55 -55 -61 -55 -61 -75 -75 -73 
-75 -75 -75 -63 -63 -63 -63 -63 -63 -61 
-63 -63 -63 -57 -57 -57 -57 -57 -55 -57 
-57 -57 -57 -57 -59 -57 -59 -59 -59 -59 
-59 -59 -59 -59 -59 -61 -61 -61 -61 -59 
-59 -59 -59 -61 -59 -59 -59 -59 -61 -61 
-63 -87 -55 -55 -55 -51 -91 -91 -53 -57 
-59 -59 -61 -59 -61 -61 -61 -55 -57 -57 
-59 -55 -57 -57 -57 -57 -57 -59 -59 -59 
-59 -61 -59 -63 -61 -61 -59 -59 -57 -63 
-61 -63 -61 -61 -61 -57 -57 -63 -61 -61 
-59 -61 -61 -63 -61 -61 -61 -61 -61 -61 
-63 -63 -61 -59 -61 -61 -61 -61 -59 -61 
-61 -59 -61 -61 -61 -61 -59 -59 -59 -59 
-61 -59 -61 -61 -61 -61 -61 -61 -61 -61 
-61 -63 -63 -61 -61 -61 -61 -63 -61 -61 
-61 -63 -63 -61 -61 -61 -63 -63 -85 -61 
-63 -63 -61 -61 -61 -61 -61 -61 -63 -61 
