-79 -81 -77 -75 -75 -75 -77 -63 -65 -65 
-65 -65 -63 -65 -67 -63 -65 -67 -65 -65 
-71 -71 -71 -71 -71 -71 -71 -73 -73 -73 
-73 -75 -73 -75 -75 -75 -75 -75 -75 -73 
-75 -73 -73 -73 -73 -71 -71 -71 -71 -71 
-71 -71 -71 -71 -71 -71 -71 -71 -71 -71 
-71 -69 -71 -71 -71 -71 -69 -71 -69 -69 
-69 -69 -71 -71 -71 -71 -71 -71 -71 -71 
-71 -73 -75 -75 -75 -73 -73 -75 -75 -77 
-75 -75 -75 -75 -75 -73 -73 -75 -73 -73 
-75 -75 -73 -75 -75 -75 -75 -75 -75 -75 
-75 -75 -75 -75 -75 -75 -73 -75 -73 -75 
-73 -73 -73 -73 -73 -75 -73 -75 -75 -77 
-77 -75 -73 -73 -75 -73 -75 -73 -73 -73 
-75 -75 -73 -75 -75 -75 -75 -75 -75 -75 
-75 -75 -75 -75 -75 -75 -75 -75 -75 -77 
-75 -75 -75 -75 -73 -75 -73 -73 -75 -71 
-71 -71 -69 -69 -69 -69 -69 -69 -69 -69 
-69 -69 -67 -69 -69 -69 -71 -69 -69 -71 
-71 -71 -69 -69 -71 -69 -71 -71 -71 -69 
-69 -69 -67 -67 -67 -69 -67 -67 -67 -67 
-67 -67 -65 -65 -65 -65 -67 -67 -65 -67 
-67 -69 -67 -67 -69 -71 -67 -69 -67 -67 
-67 -67 -67 -69 -67 -67 -69 -69 -67 -67 
-67 -75 -75 -73 -73 -75 -75 -75 -73 -73 
-75 -73 -75 -75 -75 -73 -75 -75 -75 -75 
-73 -75 -75 -75 -75 -75 -75 -75 -75 -75 
-75 -75 -75 -75 -75 -75 -75 -75 -75 -75 
-75 -77 -77 -75 -77 -75 -75 -77 -75 -75 
-75 -75 -77 -77 -75 -77 -77 -75 -75 -75 
-75 -75 -75 -75 -77 -75 -75 -75 -75 -75 
-75 -77 -77 -77 -77 -75 -75 -75 -75 -77 
-77 -77 -77 -73 -87 -89 -77 -75 -75 -75 
-89 -85 -73 -71 -71 -71 -71 -71 -71 -71 
-73 -71 -71 -83 -87 -75 -75 -73 -73 -73 
-75 -75 -75 -87 -87 -87 -81 -69 -69 -79 
-83 -75 -73 -73 -73 -73 -75 -81 -83 -75 
-75 -71 -71 -69 -71 -69 -71 -89 -73 -71 
-73 -73 -71 -73 -69 -69 -69 -69 -69 -69 
-69 -69 -71 -69 -69 -67 -67 -67 -67 -67 
-67 -67 -67 -67 -67 -67 -67 -91 -67 -67 
-67 -65 -65 -67 -67 -67 -67 -67 -69 -69 
-69 -69 -71 -69 -71 -69 -69 -69 -69 -69 
-67 -69 -69 -69 -67 -67 -65 -65 -65 -65 
-65 -63 -63 -61 -63 -63 -63 -63 -63 -63 
-65 -85 -65 -67 -65 -67 -67 -67 -67 -67 
-65 -65 -65 -65 -65 -65 -65 -65 -63 -65 
-63 -67 -65 -71 -71 -71 -71 -71 -69 -69 
-69 -67 -69 -67 -69 -67 -67 -65 -67 -65 
-65 -65 -67 -67 -67 -67 -67 -67 -67 -67 
-67 -67 -67 -67 -67 -67 -71 -71 -69 -67 
-67 -67 -69 -69 -69 -69 -67 -67 -69 -67 
-67 -67 -67 -67 -67 -67 -67 -67 -67 -67 
-67 -65 -67 -69 -69 -69 -71 -71 -67 -67 
-67 -67 -67 -65 -65 -67 -67 -65 -65 -67 
-67 -67 -67 -67 -67 -67 -69 -67 -67 -67 
-69 -69 -67 -67 -67 -69 -69 -69 -69 -67 
-69 -67 -67 -67 -69 -67 -69 -67 -67 -67 
-67 -67 -67 -67 -67 -67 -67 -67 -67 -67 
-67 -69 -69 -69 -67 -69 -67 -67 -69 -67 
-69 -67 -69 -69 -69 -67 -69 -69 -69 -67 
-67 -69 -67 -67 -69 -69 -69 -67 -69 -69 
-67 -67 -67 -69 -67 -69 -67 -69 -69 -67 
-69 -69 -67 -69 -69 -69 -69 -69 -69 -69 
-69 -67 -69 -69 -69 -69 -69 -69 -69 -69 
-67 -69 -69 -69 -69 -69 -69 -69 -69 -69 
-69 -69 -67 -69 -69 -69 -69 -69 -69 -69 
-69 -69 -69 -69 -69 -69 -69 -69 -69 -69 
-69 -69 -69 -69 -69 -69 -69 -69 -69 -71 
-69 -69 -69 -69 -69 -69 -69 -69 -69 -69 
-69 -69 -69 -69 -69 -69 -69 -69 -69 -69 
-69 -69 -71 -71 -69 -69 -69 -69 -69 -69 
-69 -69 -71 -69 -69 -71 -69 -69 -69 -69 
-71 -71 -69 -91 -71 -69 -69 -71 -71 -69 
-69 -69 -71 -71 -69 -69 -71 -69 -69 -69 
-69 -69 -69 -69 -69 -69 -67 -67 -67 -69 
-69 -69 -69 -69 -69 -69 -69 -67 -69 -67 
-67 -67 -67 -67 -67 -67 -67 -69 -69 -69 
-69 -69 -69 -69 -69 -69 -69 -69 -69 -69 
-69 -69 -69 -69 -71 -71 -87 -69 -71 -71 
-71 -69 -71 -71 -71 -71 -71 -71 -71 -71 
-71 -71 -71 -71 -71 -71 -71 -71 -71 -71 
-71 -71 -71 -71 -69 -69 -69 -67 -69 -69 
-69 -67 -69 -69 -67 -67 -65 -67 -67 -67 
-67 -67 -67 -67 -65 -67 -67 -67 -67 -67 
-69 -67 -69 -69 -69 -69 -69 -69 -69 -69 
-69 -71 -69 -71 -69 -69 -69 -71 -69 -69 
-67 -69 -69 -69 -69 -69 -71 -69 -69 -69 
-71 -69 -71 -71 -71 -69 -71 -71 -71 -71 
-71 -71 -71 -71 -71 -71 -71 -71 -71 -71 
-69 -71 -71 -71 -71 -71 -71 -71 -71 -91 
-71 -69 -69 -69 -69 -69 -69 -67 -67 -67 
-67 -67 -67 -67 -69 -69 -69 -67 -69 -67 
-69 -69 -69 -69 -69 -71 -73 -73 -73 -73 
-75 -73 -71 -69 -69 -69 -69 -71 -71 -69 
-71 -71 -71 -71 -71 -69 -71 -69 -69 -69 
-69 -71 -69 -69 -69 -69 -71 -73 -73 -71 
-71 -71 -71 -71 -71 -69 -71 -69 -71 -69 
-71 -71 -71 -71 -71 -71 -69 -71 -69 -69 
-71 -73 -73 -71 -71 -71 -71 -71 -71 -71 
