-67 -65 -67 -67 -67 -67 -63 -63 -63 -63 
-75 -77 -73 -77 -73 -73 -75 -63 -65 -63 
-65 -63 -63 -65 -65 -65 -65 -65 -65 -63 
-63 -63 -63 -61 -63 -63 -61 -63 -63 -63 
-61 -61 -91 -63 -61 -61 -61 -61 -61 -61 
-59 -61 -61 -61 -59 -59 -59 -59 -57 -59 
-57 -59 -59 -57 -59 -61 -59 -61 -59 -57 
-59 -57 -57 -57 -57 -57 -57 -57 -57 -59 
-57 -57 -57 -59 -57 -61 -59 -59 -61 -59 
-61 -61 -61 -61 -61 -61 -59 -61 -61 -61 
-61 -61 -61 -61 -61 -61 -63 -61 -61 -61 
-61 -63 -61 -61 -63 -63 -63 -61 -61 -61 
-61 -61 -61 -61 -59 -61 -59 -61 -59 -57 
-57 -59 -57 -59 -57 -61 -63 -59 -61 -61 
-61 -61 -61 -59 -59 -59 -59 -57 -57 -59 
-59 -65 -65 -63 -61 -53 -59 -59 -61 -59 
-59 -63 -59 -59 -63 -63 -61 -63 -61 -65 
-65 -55 -57 -53 -57 -55 -55 -57 -55 -55 
-55 -57 -57 -55 -57 -91 -57 -57 -55 -55 
-55 -55 -57 -57 -55 -55 -53 -55 -55 -53 
-55 -53 -53 -53 -55 -55 -53 -53 -53 -55 
-55 -53 -53 -53 -53 -55 -55 -55 -55 -55 
-69 -65 -57 -57 -69 -65 -55 -55 -55 -53 
-55 -53 -55 -53 -55 -55 -55 -63 -67 -57 
-55 -57 -55 -55 -55 -55 -57 -67 -65 -67 
-55 -55 -55 -55 -67 -59 -59 -59 -57 -57 
-57 -65 -67 -59 -57 -57 -55 -53 -55 -55 
-55 -55 -55 -59 -55 -55 -55 -55 -55 -55 
-63 -63 -65 -65 -63 -61 -59 -61 -59 -59 
-61 -59 -61 -61 -63 -61 -61 -61 -61 -61 
-59 -59 -57 -57 -59 -61 -61 -63 -63 -63 
-63 -63 -63 -63 -61 -59 -61 -63 -61 -63 
-57 -59 -57 -59 -59 -91 -59 -59 -59 -57 
-61 -61 -67 -63 -61 -55 -57 -57 -61 -59 
-61 -59 -59 -59 -59 -59 -61 -59 -61 -59 
-61 -59 -59 -59 -59 -59 -59 -57 -59 -57 
-59 -57 -57 -57 -59 -59 -57 -57 -57 -57 
-59 -59 -59 -59 -59 -57 -59 -59 -59 -59 
-59 -59 -59 -59 -59 -59 -59 -61 -61 -59 
-59 -59 -59 -59 -59 -61 -59 -61 -59 -59 
-59 -59 -59 -61 -61 -61 -61 -61 -61 -61 
-61 -61 -61 -61 -61 -59 -61 -61 -59 -61 
-61 -61 -61 -61 -61 -61 -63 -63 -63 -63 
-61 -61 -61 -63 -61 -61 -61 -61 -61 -61 
-87 -61 -59 -59 -61 -61 -61 -59 -59 -61 
-61 -61 -53 -55 -55 -55 -53 -55 -55 -55 
-57 -55 -55 -57 -57 -91 -57 -55 -57 -57 
-57 -53 -55 -55 -55 -53 -53 -53 -53 -55 
-55 -55 -55 -57 -57 -55 -55 -55 -55 -57 
-57 -57 -59 -57 -59 -57 -59 -57 -57 -57 
-57 -57 -57 -57 -55 -55 -55 -55 -55 -55 
-55 -55 -55 -57 -57 -55 -57 -55 -55 -55 
-55 -55 -53 -53 -55 -55 -55 -55 -55 -55 
-55 -55 -55 -89 -57 -55 -57 -55 -55 -55 
-55 -55 -53 -53 -53 -55 -55 -53 -53 -51 
-51 -51 -51 -51 -51 -51 -55 -55 -55 -55 
-55 -55 -55 -53 -51 -53 -51 -51 -53 -51 
-53 -53 -51 -53 -53 -53 -53 -53 -53 -51 
-53 -53 -51 -53 -53 -53 -59 -59 -55 -55 
-55 -53 -55 -57 -59 -59 -59 -59 -59 -57 
-59 -57 -57 -55 -55 -55 -53 -53 -51 -53 
-53 -53 -53 -53 -55 -53 -53 -55 -55 -53 
-53 -53 -53 -55 -55 -53 -53 -53 -53 -53 
-53 -53 -53 -53 -89 -53 -57 -55 -57 -57 
-55 -57 -55 -53 -53 -51 -53 -51 -53 -53 
-53 -53 -61 -55 -57 -53 -53 -55 -57 -57 
-57 -57 -55 -53 -51 -55 -55 -57 -59 -57 
-57 -55 -55 -53 -55 -55 -55 -57 -55 -57 
-57 -57 -55 -55 -55 -55 -57 -55 -55 -57 
-55 -55 -55 -57 -55 -55 -57 -55 -59 -55 
-57 -57 -59 -59 -57 -57 -59 -57 -55 -57 
-59 -59 -57 -57 -55 -57 -91 -57 -57 -55 
-55 -57 -57 -59 -57 -57 -59 -57 -59 -57 
-57 -55 -55 -57 -55 -57 -59 -59 -59 -59 
-59 -59 -59 -59 -59 -59 -59 -59 -59 -59 
-59 -59 -59 -59 -59 -59 -59 -59 -59 -59 
-59 -61 -59 -59 -59 -59 -59 -57 -59 -57 
-57 -57 -57 -57 -57 -57 -57 -57 -57 -59 
-57 -59 -57 -57 -57 -59 -57 -59 -57 -57 
-57 -53 -55 -55 -57 -55 -53 -53 -55 -57 
-57 -55 -55 -57 -57 -55 -55 -55 -57 -59 
-57 -57 -57 -57 -55 -53 -51 -55 -57 -55 
-55 -55 -55 -55 -55 -55 -55 -55 -51 -55 
-53 -53 -53 -53 -51 -55 -55 -55 -55 -57 
-55 -55 -53 -55 -57 -57 -55 -55 -55 -57 
-55 -57 -55 -55 -55 -51 -51 -51 -51 -49 
-53 -51 -51 -53 -47 -49 -53 -49 -49 -49 
-51 -49 -49 -49 -51 -51 -51 -51 -49 -51 
-51 -49 -51 -51 -51 -51 -53 -53 -51 -51 
-53 -53 -51 -51 -49 -49 -49 -49 -51 -49 
-61 -65 -61 -61 -59 -61 -63 -61 -61 -61 
-77 -51 -49 -51 -51 -51 -51 -47 -49 -49 
-51 -51 -49 -51 -51 -47 -49 -49 -51 -51 
-51 -51 -51 -59 -61 -61 -59 -63 -61 -59 
-61 -61 -61 -61 -61 -61 -51 -61 -49 -51 
-49 -51 -51 -51 -51 -51 -51 -51 -77 -59 
-63 -63 -61 -61 -51 -49 -47 -49 -49 -49 
-49 -49 -53 -51 -51 -51 -51 -51 -51 -51 
-51 -51 -51 -51 -51 -51 -65 -61 -51 -51 
-51 -65 -63 -63 -61 -51 -51 -61 -63 -51 
