-45 -45 -47 -47 -47 -45 -45 -45 -47 -49 
-45 -45 -45 -45 -45 -55 -59 -47 -55 -57 
-59 -45 -89 -91 -47 -45 -47 -45 -47 -45 
-47 -45 -45 -45 -47 -47 -45 -45 -57 -57 
-53 -53 -55 -55 -55 -53 -55 -53 -57 -53 
-53 -53 -53 -49 -49 -49 -49 -49 -47 -49 
-49 -55 -53 -53 -55 -53 -49 -49 -49 -49 
-47 -45 -45 -45 -47 -47 -45 -47 -45 -45 
-45 -47 -45 -45 -47 -47 -47 -29 -47 -47 
-49 -49 -49 -49 -49 -49 -49 -51 -53 -51 
-55 -53 -55 -57 -55 -53 -51 -45 -49 -51 
-51 -53 -55 -55 -55 -55 -55 -53 -53 -55 
-53 -53 -53 -51 -51 -51 -51 -49 -49 -49 
-51 -49 -49 -49 -49 -47 -49 -49 -49 -47 
-47 -47 -45 -47 -45 -45 -47 -45 -45 -45 
-45 -47 -47 -47 -47 -47 -47 -47 -47 -47 
-47 -45 -47 -45 -45 -45 -45 -45 -47 -47 
-47 -47 -47 -47 -47 -47 -47 -49 -49 -49 
-47 -49 -49 -51 -53 -53 -55 -53 -53 -53 
-51 -51 -49 -49 -53 -53 -53 -53 -53 -53 
-51 -51 -49 -51 -51 -53 -51 -51 -51 -51 
-51 -51 -51 -53 -51 -51 -51 -45 -45 -45 
-45 -45 -45 -45 -51 -47 -45 -45 -45 -45 
-45 -45 -49 -49 -49 -49 -47 -49 -49 -47 
-49 -47 -49 -49 -47 -49 -47 -47 -47 -49 
-47 -49 -47 -49 -47 -49 -49 -47 -49 -49 
-49 -47 -47 -47 -47 -49 -47 -47 -47 -47 
-49 -47 -47 -49 -47 -49 -47 -47 -47 -47 
-47 -47 -47 -47 -47 -47 -47 -47 -47 -47 
-47 -47 -47 -47 -47 -47 -47 -47 -91 -47 
-47 -47 -47 -47 -47 -47 -47 -47 -47 -47 
-47 -47 -47 -47 -47 -47 -47 -47 -47 -47 
-49 -43 -43 -49 -49 -47 -47 -49 -49 -47 
-49 -47 -49 -47 -47 -47 -47 -47 -49 -47 
-49 -47 -47 -47 -47 -49 -47 -47 -47 -49 
-47 -47 -47 -47 -47 -47 -47 -47 -47 -49 
-37 -47 -47 -47 -47 -47 -47 -47 -77 -91 
-47 -47 -47 -47 -47 -47 -47 -47 -49 -49 
-47 -47 -49 -49 -49 -49 -47 -91 -47 -47 
-47 -47 -47 -47 -47 -49 -49 -47 -47 -47 
-47 -47 -47 -47 -47 -45 -47 -45 -45 -45 
-45 -45 -45 -47 -45 -45 -45 -45 -45 -45 
-45 -45 -45 -91 -45 -47 -45 -45 -45 -45 
-45 -45 -45 -45 -47 -47 -45 -45 -43 -45 
-43 -45 -47 -47 -45 -45 -45 -45 -45 -45 
-45 -91 -47 -47 -47 -45 -45 -45 -45 -45 
-45 -49 -43 -43 -45 -47 -45 -45 -45 -45 
-47 -47 -45 -47 -45 -45 -45 -45 -47 -45 
-47 -45 -45 -45 -45 -45 -45 -45 -45 -47 
-47 -47 -45 -45 -45 -47 -47 -45 -43 -43 
-43 -43 -43 -45 -45 -45 -45 -47 -45 -45 
-45 -45 -45 -45 -45 -45 -43 -45 -43 -91 
-45 -45 -47 -47 -47 -47 -47 -45 -45 -45 
-43 -45 -45 -45 -45 -45 -45 -45 -45 -47 
-47 -47 -45 -47 -45 -47 -47 -47 -45 -45 
-43 -43 -45 -43 -45 -45 -47 -47 -47 -45 
-45 -47 -47 -45 -45 -47 -45 -47 -47 -47 
-45 -45 -47 -47 -47 -47 -47 -47 -47 -47 
-47 -47 -47 -47 -47 -47 -47 -47 -47 -47 
-47 -47 -47 -47 -47 -47 -47 -45 -59 -57 
-49 -47 -47 -45 -45 -45 -45 -47 -45 -47 
-45 -61 -61 -51 -51 -49 -49 -49 -49 -49 
-49 -47 -57 -61 -49 -49 -47 -45 -45 -45 
-45 -45 -45 -45 -45 -45 -43 -45 -47 -45 
-47 -45 -45 -45 -45 -45 -45 -45 -47 -45 
-45 -47 -45 -47 -47 -45 -45 -45 -45 -45 
-45 -45 -45 -43 -45 -43 -43 -43 -43 -43 
-43 -43 -45 -43 -45 -47 -45 -47 -47 -45 
-47 -49 -47 -49 -47 -49 -49 -49 -49 -45 
-45 -47 -45 -45 -45 -45 -45 -45 -45 -45 
-49 -49 -49 -51 -51 -51 -45 -45 -47 -47 
-45 -45 -45 -45 -47 -45 -45 -45 -47 -47 
-47 -45 -49 -49 -49 -49 -49 -49 -43 -45 
-47 -45 -45 -47 -45 -47 -47 -45 -45 -49 
-49 -49 -49 -47 -39 -39 -39 -41 -41 -43 
-41 -41 -41 -41 -41 -41 -43 -43 -43 -39 
-41 -41 -41 -41 -41 -43 -41 -41 -43 -43 
-41 -43 -43 -45 -43 -43 -45 -45 -43 -45 
-45 -47 -43 -47 -47 -47 -47 -47 -47 -47 
-49 -49 -47 -47 -47 -47 -47 -47 -47 -47 
-47 -45 -47 -45 -47 -49 -47 -47 -47 -91 
-47 -45 -47 -47 -45 -45 -45 -47 -93 -47 
-47 -47 -47 -47 -47 -47 -49 -49 -47 -49 
-49 -49 -49 -49 -47 -49 -49 -47 -49 -49 
-47 -47 -47 -45 -45 -49 -49 -49 -47 -47 
-47 -47 -49 -91 -49 -47 -49 -47 -49 -49 
-49 -49 -49 -49 -51 -49 -49 -51 -49 -49 
-49 -49 -49 -49 -45 -45 -43 -45 -47 -47 
-45 -45 -45 -47 -45 -43 -43 -43 -43 -43 
-43 -45 -45 -47 -47 -45 -47 -45 -45 -43 
-49 -45 -47 -45 -45 -47 -47 -47 -45 -47 
-45 -47 -45 -45 -47 -45 -47 -45 -47 -47 
-45 -47 -43 -43 -45 -45 -45 -47 -47 -47 
-45 -47 -45 -45 -47 -45 -45 -47 -47 -49 
-47 -45 -43 -47 -45 -43 -49 -47 -49 -47 
-47 -49 -49 -47 -47 -45 -45 -47 -47 -45 
-45 -45 -45 -43 -43 -41 -43 -43 -43 -45 
-45 -47 -47 -45 -45 -45 -43 -43 -43 -43 
-45 -43 -43 -49 -53 -47 -45 -45 -47 -49 
-47 -43 -43 -47 -47 -45 -45 -47 -47 -45 
